STATE,COUNTY,TRACT,BLOCK_GROUP,NAME,B25003_003E,B25003_002E,B25003_001E,B25038_011E,B25038_010E,B25038_015E,B25038_014E,B25038_013E,B25038_012E,B25038_003E,B25038_002E,B25038_001E,B25038_008E,B25038_007E,B25038_006E,B25038_005E,B25038_004E,B25038_009E,B25039_002E,B25039_001E,B25039_003E,B25057_001E,B25058_001E,B25059_001E,B25071_001E,B19013_001E,B01003_001E,GEOID
36,071,000501,1,"Block Group 1, Census Tract 5.01, Orange County, New York",441,83,524,258,41,0,12,36,94,0,83,524,9,21,0,53,0,441,2002.0,2011.0,2012.0,661.0,909.0,1052.0,40.8,35000.0,2070,36071000501
36,071,000501,2,"Block Group 2, Census Tract 5.01, Orange County, New York",323,24,347,188,0,14,0,39,82,9,24,347,0,0,15,0,0,323,1999.0,2011.0,2011.0,470.0,840.0,968.0,36.5,30144.0,596,36071000501
36,071,000501,3,"Block Group 3, Census Tract 5.01, Orange County, New York",229,38,267,102,96,0,19,0,12,0,38,267,16,0,0,5,17,229,2006.0,2013.0,2014.0,780.0,855.0,1104.0,29.2,56336.0,777,36071000501
36,079,011000,4,"Block Group 4, Census Tract 110, Putnam County, New York",46,561,607,23,0,0,11,0,12,23,561,607,104,141,83,158,52,46,1994.0,1996.0,2010.0,,1325.0,1413.0,31.7,132340.0,1745,36079011000
36,079,011000,1,"Block Group 1, Census Tract 110, Putnam County, New York",11,294,305,0,0,0,0,0,11,0,294,305,31,24,53,176,10,11,2002.0,2002.0,,,,,,150208.0,928,36079011000
36,027,300000,1,"Block Group 1, Census Tract 3000, Dutchess County, New York",124,143,267,72,52,0,0,0,0,0,143,267,17,0,58,68,0,124,1999.0,2009.0,2014.0,1123.0,1246.0,1708.0,24.8,60078.0,832,36027300000
36,027,300000,2,"Block Group 2, Census Tract 3000, Dutchess County, New York",657,236,893,331,124,0,0,54,148,0,236,893,33,15,70,106,12,657,2000.0,2010.0,2012.0,1052.0,1166.0,1323.0,41.0,42744.0,2212,36027300000
36,027,020004,1,"Block Group 1, Census Tract 200.04, Dutchess County, New York",9,170,179,5,0,0,0,0,4,8,170,179,7,25,41,68,21,9,2002.0,2002.0,2012.0,831.0,862.0,893.0,45.3,110156.0,477,36027020004
36,027,020004,2,"Block Group 2, Census Tract 200.04, Dutchess County, New York",11,454,465,7,0,0,0,0,4,18,454,465,61,36,120,172,47,11,2001.0,2001.0,,,,,,110375.0,1457,36027020004
36,027,020004,3,"Block Group 3, Census Tract 200.04, Dutchess County, New York",21,246,267,18,0,0,0,3,0,5,246,267,11,52,58,78,42,21,2000.0,2001.0,2012.0,,,,,122019.0,798,36027020004
36,027,020005,1,"Block Group 1, Census Tract 200.05, Dutchess County, New York",182,479,661,68,95,0,9,10,0,8,479,661,76,32,143,180,40,182,1999.0,2003.0,2016.0,955.0,1317.0,1809.0,21.6,97750.0,2077,36027020005
36,027,020005,2,"Block Group 2, Census Tract 200.05, Dutchess County, New York",0,330,330,0,0,0,0,0,0,0,330,330,32,28,117,121,32,0,1999.0,1999.0,,,,,,107891.0,1021,36027020005
36,027,020005,3,"Block Group 3, Census Tract 200.05, Dutchess County, New York",67,190,257,38,0,0,0,0,29,0,190,257,9,42,51,63,25,67,1999.0,2003.0,2011.0,848.0,1076.0,1186.0,38.0,86823.0,489,36027020005
36,027,020005,4,"Block Group 4, Census Tract 200.05, Dutchess County, New York",28,611,639,0,14,0,0,0,14,27,611,639,36,0,177,305,66,28,2003.0,2003.0,2008.0,840.0,881.0,1335.0,21.1,92243.0,1766,36027020005
36,027,030000,2,"Block Group 2, Census Tract 300, Dutchess County, New York",27,374,401,10,0,0,9,0,8,10,374,401,26,53,30,214,41,27,2004.0,2004.0,2006.0,,,,,105865.0,1324,36027030000
36,027,030000,3,"Block Group 3, Census Tract 300, Dutchess County, New York",30,239,269,14,0,0,0,16,0,0,239,269,0,28,86,80,45,30,2001.0,2001.0,1999.0,497.0,672.0,,50.0,125188.0,613,36027030000
36,027,030000,4,"Block Group 4, Census Tract 300, Dutchess County, New York",159,231,390,96,36,0,8,10,9,0,231,390,44,84,34,62,7,159,1989.0,2002.0,2013.0,815.0,1006.0,1359.0,19.6,97625.0,951,36027030000
36,027,040003,1,"Block Group 1, Census Tract 400.03, Dutchess County, New York",272,443,715,108,60,0,0,0,104,0,443,715,99,77,88,148,31,272,1995.0,2004.0,2011.0,692.0,848.0,1122.0,43.2,44293.0,1765,36027040003
36,027,040003,2,"Block Group 2, Census Tract 400.03, Dutchess County, New York",79,215,294,63,0,0,0,0,16,26,215,294,28,30,30,91,10,79,2002.0,2006.0,2012.0,515.0,546.0,648.0,24.1,64181.0,991,36027040003
36,027,040003,3,"Block Group 3, Census Tract 400.03, Dutchess County, New York",85,317,402,0,60,0,0,0,25,31,317,402,0,10,99,71,106,85,2007.0,2010.0,2016.0,521.0,822.0,893.0,39.8,41413.0,1110,36027040003
36,027,050103,1,"Block Group 1, Census Tract 501.03, Dutchess County, New York",0,243,243,0,0,0,0,0,0,18,243,243,40,44,84,48,9,0,1994.0,1994.0,,,,,,105972.0,927,36027050103
36,027,050103,2,"Block Group 2, Census Tract 501.03, Dutchess County, New York",43,446,489,43,0,0,0,0,0,50,446,489,50,121,101,79,45,43,1995.0,1997.0,,,,,,105313.0,1549,36027050103
36,027,050103,3,"Block Group 3, Census Tract 501.03, Dutchess County, New York",45,321,366,19,0,0,0,0,26,5,321,366,24,53,124,84,31,45,1997.0,1999.0,2009.0,843.0,876.0,,50.0,142228.0,1324,36027050103
36,027,050103,4,"Block Group 4, Census Tract 501.03, Dutchess County, New York",0,169,169,0,0,0,0,0,0,0,169,169,30,35,69,21,14,0,1993.0,1993.0,,,,,,132750.0,551,36027050103
36,027,050103,5,"Block Group 5, Census Tract 501.03, Dutchess County, New York",92,368,460,27,20,0,0,17,28,5,368,460,100,42,72,109,40,92,1996.0,2000.0,2010.0,882.0,1009.0,1222.0,45.0,87500.0,1243,36027050103
36,027,050104,1,"Block Group 1, Census Tract 501.04, Dutchess County, New York",0,283,283,0,0,0,0,0,0,27,283,283,83,18,0,141,14,0,2003.0,2003.0,,,,,,140339.0,892,36027050104
36,027,050104,2,"Block Group 2, Census Tract 501.04, Dutchess County, New York",59,992,1051,59,0,0,0,0,0,18,992,1051,55,114,162,453,190,59,2004.0,2004.0,,,,,,102868.0,3424,36027050104
36,027,050104,3,"Block Group 3, Census Tract 501.04, Dutchess County, New York",21,291,312,21,0,0,0,0,0,21,291,312,17,52,164,37,0,21,1995.0,1995.0,,,,,,86176.0,927,36027050104
36,027,050104,4,"Block Group 4, Census Tract 501.04, Dutchess County, New York",34,522,556,20,0,0,0,0,14,83,522,556,35,16,96,187,105,34,2006.0,2007.0,,,,,,132969.0,1581,36027050104
36,027,050203,1,"Block Group 1, Census Tract 502.03, Dutchess County, New York",29,253,282,8,10,0,0,0,11,19,253,282,40,92,28,59,15,29,1989.0,1993.0,2012.0,,,,,88929.0,787,36027050203
36,027,050203,2,"Block Group 2, Census Tract 502.03, Dutchess County, New York",24,399,423,8,0,0,0,0,16,0,399,423,81,61,101,91,65,24,1996.0,1997.0,2008.0,875.0,950.0,1063.0,17.5,147625.0,1245,36027050203
36,027,050203,3,"Block Group 3, Census Tract 502.03, Dutchess County, New York",187,426,613,81,18,23,7,22,36,23,426,613,22,54,102,140,85,187,2003.0,2004.0,2010.0,864.0,1048.0,1333.0,45.1,67321.0,1541,36027050203
36,027,050203,4,"Block Group 4, Census Tract 502.03, Dutchess County, New York",17,323,340,0,0,0,9,8,0,16,323,340,50,17,41,176,23,17,2003.0,2003.0,,,,,,120972.0,1002,36027050203
36,027,050204,1,"Block Group 1, Census Tract 502.04, Dutchess County, New York",25,550,575,21,4,0,0,0,0,11,550,575,53,37,167,246,36,25,2001.0,2001.0,2013.0,574.0,1650.0,1719.0,43.5,135917.0,1814,36027050204
36,027,050204,2,"Block Group 2, Census Tract 502.04, Dutchess County, New York",30,336,366,11,13,0,0,0,6,4,336,366,47,46,86,122,31,30,1999.0,2000.0,2014.0,1063.0,1614.0,1807.0,42.9,59000.0,985,36027050204
36,027,050205,1,"Block Group 1, Census Tract 502.05, Dutchess County, New York",60,567,627,0,22,0,0,8,30,17,567,627,51,45,178,218,58,60,2000.0,2001.0,2007.0,,2060.0,2205.0,41.4,144213.0,2103,36027050205
36,001,014301,2,"Block Group 2, Census Tract 143.01, Albany County, New York",242,505,747,127,42,8,0,7,58,60,505,747,69,49,96,204,27,242,2002.0,2006.0,2012.0,693.0,823.0,889.0,30.2,76205.0,2028,36001014301
36,071,000502,1,"Block Group 1, Census Tract 5.02, Orange County, New York",283,74,357,167,76,0,0,0,40,0,74,357,0,26,0,48,0,283,2002.0,2012.0,2013.0,741.0,942.0,990.0,33.7,36908.0,1429,36071000502
36,071,000502,2,"Block Group 2, Census Tract 5.02, Orange County, New York",138,63,201,34,21,0,0,44,39,0,63,201,0,0,0,63,0,138,,2006.0,2006.0,711.0,769.0,891.0,41.1,35938.0,558,36071000502
36,071,000502,3,"Block Group 3, Census Tract 5.02, Orange County, New York",236,34,270,95,44,0,27,19,51,0,34,270,0,19,0,15,0,236,1989.0,2010.0,2011.0,670.0,746.0,1107.0,30.7,56667.0,986,36071000502
36,071,000502,4,"Block Group 4, Census Tract 5.02, Orange County, New York",182,77,259,57,39,0,0,8,78,7,77,259,21,0,23,26,0,182,1998.0,2007.0,2010.0,706.0,736.0,1023.0,32.9,40347.0,892,36071000502
36,071,010101,1,"Block Group 1, Census Tract 101.01, Orange County, New York",43,590,633,7,0,0,0,0,36,9,590,633,98,124,80,251,28,43,1999.0,2001.0,,,,,,100784.0,1802,36071010101
36,071,010101,2,"Block Group 2, Census Tract 101.01, Orange County, New York",42,397,439,42,0,0,0,0,0,11,397,439,28,42,171,85,60,42,1998.0,1999.0,2011.0,1109.0,1219.0,1484.0,50.0,124625.0,1279,36071010101
36,071,010101,3,"Block Group 3, Census Tract 101.01, Orange County, New York",34,497,531,32,0,0,0,0,2,24,497,531,37,59,96,212,69,34,2003.0,2003.0,2012.0,1555.0,1703.0,1852.0,51.0,100250.0,1911,36071010101
36,071,010102,1,"Block Group 1, Census Tract 101.02, Orange County, New York",97,171,268,67,11,11,0,0,8,0,171,268,19,0,23,129,0,97,2003.0,2006.0,2012.0,1545.0,1697.0,1848.0,29.7,97647.0,770,36071010102
36,071,010102,2,"Block Group 2, Census Tract 101.02, Orange County, New York",108,396,504,49,0,13,0,0,46,9,396,504,9,53,37,223,65,108,2004.0,2005.0,2009.0,857.0,1515.0,1758.0,32.2,99250.0,1473,36071010102
36,071,010102,3,"Block Group 3, Census Tract 101.02, Orange County, New York",34,486,520,13,12,0,0,0,9,6,486,520,38,98,134,144,66,34,1998.0,1999.0,2013.0,547.0,833.0,1014.0,24.4,107214.0,1693,36071010102
36,071,010102,4,"Block Group 4, Census Tract 101.02, Orange County, New York",76,478,554,52,14,0,10,0,0,35,478,554,97,41,52,163,90,76,2003.0,2005.0,2013.0,1034.0,1106.0,1178.0,23.6,89737.0,1245,36071010102
36,071,010801,1,"Block Group 1, Census Tract 108.01, Orange County, New York",38,227,265,0,22,0,0,0,16,14,227,265,69,26,10,36,72,38,2002.0,2005.0,2016.0,,,,,41406.0,704,36071010801
36,071,010801,2,"Block Group 2, Census Tract 108.01, Orange County, New York",191,637,828,66,56,0,5,5,59,35,637,828,8,72,132,313,77,191,2003.0,2005.0,2012.0,501.0,832.0,1051.0,33.8,65909.0,2136,36071010801
36,071,010801,3,"Block Group 3, Census Tract 108.01, Orange County, New York",242,310,552,109,46,0,0,15,72,40,310,552,32,29,65,91,53,242,2003.0,2008.0,2012.0,734.0,965.0,1122.0,22.5,52917.0,1277,36071010801
36,071,010802,1,"Block Group 1, Census Tract 108.02, Orange County, New York",581,378,959,262,155,45,0,0,119,0,378,959,20,30,70,211,47,581,2003.0,2010.0,2012.0,768.0,1065.0,1215.0,33.4,56063.0,2196,36071010802
36,071,010802,2,"Block Group 2, Census Tract 108.02, Orange County, New York",31,285,316,7,0,0,24,0,0,0,285,316,74,72,37,93,9,31,1990.0,1989.0,2011.0,,,1731.0,50.0,82738.0,1104,36071010802
36,071,010802,3,"Block Group 3, Census Tract 108.02, Orange County, New York",30,612,642,0,8,0,0,22,0,6,612,642,125,56,126,252,47,30,2000.0,1999.0,1999.0,1597.0,2057.0,2278.0,22.6,119833.0,2330,36071010802
36,071,010901,1,"Block Group 1, Census Tract 109.01, Orange County, New York",67,453,520,49,11,0,0,7,0,42,453,520,25,72,111,145,58,67,2001.0,2003.0,2013.0,939.0,1266.0,1440.0,41.5,80400.0,1347,36071010901
36,071,010901,2,"Block Group 2, Census Tract 109.01, Orange County, New York",360,442,802,144,125,0,0,25,66,0,442,802,75,8,117,192,50,360,2001.0,2007.0,2013.0,448.0,770.0,897.0,37.6,42628.0,1797,36071010901
36,071,010902,1,"Block Group 1, Census Tract 109.02, Orange County, New York",91,650,741,63,0,0,0,11,17,0,650,741,97,79,184,236,54,91,1998.0,2000.0,2011.0,1107.0,1647.0,2643.0,32.9,89632.0,2666,36071010902
36,071,010902,2,"Block Group 2, Census Tract 109.02, Orange County, New York",13,379,392,5,0,0,0,8,0,0,379,392,34,19,110,167,49,13,2002.0,2001.0,,,,,,114565.0,1287,36071010902
36,071,010902,3,"Block Group 3, Census Tract 109.02, Orange County, New York",48,386,434,8,0,11,0,10,19,6,386,434,53,53,33,171,70,48,2003.0,2003.0,2002.0,813.0,1011.0,1222.0,21.5,90745.0,1272,36071010902
36,071,010902,4,"Block Group 4, Census Tract 109.02, Orange County, New York",51,290,341,8,0,9,0,0,34,43,290,341,27,66,23,112,19,51,2003.0,2003.0,2005.0,807.0,838.0,869.0,18.1,86094.0,865,36071010902
36,071,011101,1,"Block Group 1, Census Tract 111.01, Orange County, New York",15,394,409,0,0,6,9,0,0,8,394,409,63,33,27,210,53,15,2004.0,2003.0,,,,,,98839.0,1275,36071011101
36,071,011101,2,"Block Group 2, Census Tract 111.01, Orange County, New York",96,369,465,33,28,0,0,21,14,22,369,465,73,52,113,109,0,96,1995.0,1998.0,2012.0,1007.0,1181.0,1391.0,31.5,80375.0,1371,36071011101
36,071,011102,1,"Block Group 1, Census Tract 111.02, Orange County, New York",567,64,631,285,87,0,0,26,169,0,64,631,33,13,8,10,0,567,1979.0,2011.0,2012.0,1108.0,1268.0,1423.0,28.8,59395.0,1468,36071011102
36,071,011102,2,"Block Group 2, Census Tract 111.02, Orange County, New York",111,345,456,81,21,0,0,9,0,7,345,456,24,49,85,88,92,111,2002.0,2007.0,2013.0,982.0,1096.0,1220.0,50.0,80694.0,1341,36071011102
36,071,011102,3,"Block Group 3, Census Tract 111.02, Orange County, New York",39,421,460,29,0,0,0,0,10,10,421,460,91,15,136,89,80,39,1998.0,1999.0,2012.0,998.0,1113.0,1229.0,50.0,67256.0,1218,36071011102
36,071,011601,1,"Block Group 1, Census Tract 116.01, Orange County, New York",19,453,472,0,0,10,0,0,9,10,453,472,74,102,56,101,110,19,1999.0,1999.0,2018.0,747.0,1027.0,1139.0,19.5,60938.0,1168,36071011601
36,071,011601,2,"Block Group 2, Census Tract 116.01, Orange County, New York",195,623,818,68,26,0,0,0,101,82,623,818,75,43,123,228,72,195,2003.0,2005.0,2010.0,579.0,689.0,928.0,38.8,51726.0,2091,36071011601
36,071,011601,3,"Block Group 3, Census Tract 116.01, Orange County, New York",135,185,320,92,43,0,0,0,0,11,185,320,10,43,59,53,9,135,1997.0,2009.0,2014.0,764.0,860.0,1083.0,46.9,40893.0,864,36071011601
36,071,011602,1,"Block Group 1, Census Tract 116.02, Orange County, New York",19,814,833,10,9,0,0,0,0,17,814,833,119,166,105,290,117,19,2001.0,2001.0,2013.0,,768.0,904.0,,49750.0,2092,36071011602
36,071,011602,2,"Block Group 2, Census Tract 116.02, Orange County, New York",57,234,291,25,9,0,0,0,23,0,234,291,50,42,14,89,39,57,2001.0,2004.0,2011.0,811.0,841.0,870.0,50.0,73147.0,894,36071011602
36,071,011602,3,"Block Group 3, Census Tract 116.02, Orange County, New York",108,233,341,27,8,0,0,21,52,18,233,341,54,49,47,65,0,108,1993.0,2000.0,2006.0,650.0,791.0,1017.0,14.7,48194.0,690,36071011602
36,071,011701,1,"Block Group 1, Census Tract 117.01, Orange County, New York",6,533,539,0,6,0,0,0,0,17,533,539,27,73,78,213,125,6,2004.0,2004.0,,,,,,116678.0,1631,36071011701
36,071,011400,3,"Block Group 3, Census Tract 114, Orange County, New York",22,439,461,0,0,9,0,6,7,36,439,461,71,49,22,180,81,22,2004.0,2004.0,1993.0,,764.0,808.0,22.2,91719.0,1429,36071011400
36,071,011400,2,"Block Group 2, Census Tract 114, Orange County, New York",7,213,220,7,0,0,0,0,0,0,213,220,30,47,35,65,36,7,1998.0,1999.0,,,,,,63676.0,606,36071011400
36,071,011400,1,"Block Group 1, Census Tract 114, Orange County, New York",116,566,682,49,15,0,17,0,35,42,566,682,75,81,136,132,100,116,1999.0,2002.0,2011.0,821.0,857.0,,19.2,68261.0,2056,36071011400
36,071,013000,4,"Block Group 4, Census Tract 130, Orange County, New York",231,357,588,147,25,0,0,30,29,12,357,588,82,30,58,105,70,231,2001.0,2007.0,2012.0,971.0,1125.0,1679.0,29.2,74911.0,1693,36071013000
36,071,013000,1,"Block Group 1, Census Tract 130, Orange County, New York",177,294,471,141,18,0,0,0,18,5,294,471,52,11,114,51,61,177,1997.0,2008.0,2013.0,998.0,1526.0,1792.0,31.6,92650.0,1239,36071013000
36,071,013000,3,"Block Group 3, Census Tract 130, Orange County, New York",46,188,234,17,0,0,9,11,9,0,188,234,36,26,23,61,42,46,2001.0,2002.0,2003.0,1022.0,1125.0,1228.0,31.7,69000.0,480,36071013000
36,071,013000,2,"Block Group 2, Census Tract 130, Orange County, New York",206,246,452,93,113,0,0,0,0,15,246,452,26,26,52,82,45,206,2002.0,2011.0,2016.0,786.0,963.0,1390.0,36.5,59886.0,1412,36071013000
36,071,013400,2,"Block Group 2, Census Tract 134, Orange County, New York",70,181,251,14,13,5,5,14,19,0,181,251,26,14,9,105,27,70,2004.0,2004.0,2006.0,1299.0,1467.0,2010.0,33.3,72232.0,698,36071013400
36,071,013400,1,"Block Group 1, Census Tract 134, Orange County, New York",63,162,225,24,15,0,0,10,14,0,162,225,15,10,19,93,25,63,2004.0,2005.0,2012.0,865.0,1125.0,1313.0,28.1,85677.0,555,36071013400
36,071,013400,3,"Block Group 3, Census Tract 134, Orange County, New York",56,518,574,22,15,4,0,0,15,9,518,574,122,48,126,118,95,56,1997.0,1999.0,2012.0,433.0,960.0,1682.0,26.2,95781.0,1844,36071013400
36,071,014600,2,"Block Group 2, Census Tract 146, Orange County, New York",302,667,969,161,0,0,0,0,141,73,667,969,18,42,98,289,147,302,2006.0,2008.0,2010.0,530.0,844.0,1637.0,27.0,79763.0,2327,36071014600
36,071,014600,5,"Block Group 5, Census Tract 146, Orange County, New York",326,272,598,127,75,0,0,0,124,0,272,598,92,0,40,73,67,326,2001.0,2008.0,2012.0,636.0,931.0,1211.0,23.7,70769.0,1362,36071014600
36,071,014600,3,"Block Group 3, Census Tract 146, Orange County, New York",28,390,418,14,14,0,0,0,0,0,390,418,31,50,34,164,111,28,2005.0,2006.0,,,,,,96354.0,944,36071014600
36,071,014600,4,"Block Group 4, Census Tract 146, Orange County, New York",179,155,334,56,34,0,0,72,17,27,155,334,47,0,14,46,21,179,2004.0,2005.0,2010.0,926.0,967.0,1443.0,50.0,89118.0,885,36071014600
36,071,014600,1,"Block Group 1, Census Tract 146, Orange County, New York",191,291,482,144,13,0,17,0,17,12,291,482,35,41,64,94,45,191,2001.0,2008.0,2012.0,881.0,1216.0,1788.0,50.0,70809.0,1239,36071014600
36,071,014600,6,"Block Group 6, Census Tract 146, Orange County, New York",0,120,120,0,0,0,0,0,0,0,120,120,0,14,22,69,15,0,2003.0,2003.0,,,,,,127000.0,484,36071014600
36,071,010300,1,"Block Group 1, Census Tract 103, Orange County, New York",18,434,452,12,0,6,0,0,0,34,434,452,64,66,93,130,47,18,1999.0,2000.0,,,,,,85479.0,1326,36071010300
36,071,010300,3,"Block Group 3, Census Tract 103, Orange County, New York",44,302,346,13,0,0,9,0,22,5,302,346,61,20,61,113,42,44,2001.0,2002.0,2006.0,1096.0,1169.0,2143.0,38.8,79012.0,923,36071010300
36,071,010300,2,"Block Group 2, Census Tract 103, Orange County, New York",122,300,422,109,0,0,0,6,7,5,300,422,98,41,42,64,50,122,1993.0,2003.0,2012.0,738.0,1174.0,1576.0,28.8,63553.0,1399,36071010300
36,071,010400,3,"Block Group 3, Census Tract 104, Orange County, New York",321,379,700,176,35,17,9,22,62,7,379,700,55,64,39,165,49,321,2002.0,2006.0,2011.0,970.0,1233.0,1817.0,31.4,71742.0,1892,36071010400
36,071,010400,1,"Block Group 1, Census Tract 104, Orange County, New York",90,407,497,61,8,0,0,0,21,8,407,497,75,53,74,140,57,90,2000.0,2003.0,2012.0,968.0,1083.0,1201.0,19.8,71779.0,1452,36071010400
36,071,010400,2,"Block Group 2, Census Tract 104, Orange County, New York",75,198,273,42,0,0,0,11,22,6,198,273,65,24,40,34,29,75,1993.0,1999.0,2011.0,622.0,645.0,782.0,14.5,56815.0,681,36071010400
36,071,010600,2,"Block Group 2, Census Tract 106, Orange County, New York",241,450,691,115,126,0,0,0,0,16,450,691,69,74,21,197,73,241,2003.0,2009.0,2016.0,955.0,1491.0,1747.0,30.6,86607.0,2074,36071010600
36,071,010600,4,"Block Group 4, Census Tract 106, Orange County, New York",99,382,481,99,0,0,0,0,0,11,382,481,41,129,91,14,96,99,1992.0,1998.0,,1037.0,1108.0,1179.0,24.7,71298.0,1234,36071010600
36,071,010600,3,"Block Group 3, Census Tract 106, Orange County, New York",0,196,196,0,0,0,0,0,0,10,196,196,12,38,69,26,41,0,1997.0,1997.0,,,,,,92500.0,586,36071010600
36,071,010600,5,"Block Group 5, Census Tract 106, Orange County, New York",57,319,376,44,0,13,0,0,0,12,319,376,13,113,95,73,13,57,1994.0,1995.0,2012.0,,,,,102446.0,1341,36071010600
36,071,010600,1,"Block Group 1, Census Tract 106, Orange County, New York",67,599,666,32,0,0,13,13,9,24,599,666,53,39,267,146,70,67,1998.0,1998.0,2008.0,1024.0,1221.0,1365.0,33.0,99000.0,1951,36071010600
36,021,000500,1,"Block Group 1, Census Tract 5, Columbia County, New York",229,639,868,149,65,0,0,0,15,14,639,868,146,93,141,164,81,229,1996.0,2003.0,2013.0,711.0,789.0,1093.0,38.7,74659.0,2280,36021000500
36,021,000600,1,"Block Group 1, Census Tract 6, Columbia County, New York",115,200,315,44,15,0,0,0,56,7,200,315,50,42,24,63,14,115,1993.0,2003.0,2010.0,494.0,575.0,903.0,27.6,46563.0,734,36021000600
36,021,000600,2,"Block Group 2, Census Tract 6, Columbia County, New York",68,393,461,26,0,4,0,18,20,12,393,461,35,60,92,146,48,68,2001.0,2001.0,2006.0,513.0,562.0,918.0,28.1,58977.0,1150,36021000600
36,021,000600,3,"Block Group 3, Census Tract 6, Columbia County, New York",164,167,331,61,30,15,0,20,38,15,167,331,13,4,75,45,15,164,1999.0,2005.0,2011.0,671.0,813.0,933.0,26.6,51473.0,841,36021000600
36,021,000700,1,"Block Group 1, Census Tract 7, Columbia County, New York",67,457,524,14,0,0,0,0,53,15,457,524,129,138,17,132,26,67,1987.0,1990.0,2006.0,706.0,756.0,778.0,14.4,62105.0,1455,36021000700
36,021,000700,2,"Block Group 2, Census Tract 7, Columbia County, New York",83,170,253,71,0,0,0,0,12,34,170,253,46,0,0,59,31,83,2007.0,2010.0,2012.0,,1301.0,1394.0,50.0,63594.0,782,36021000700
36,021,000700,3,"Block Group 3, Census Tract 7, Columbia County, New York",51,422,473,51,0,0,0,0,0,13,422,473,72,37,33,156,111,51,2004.0,2006.0,,,,,,80604.0,1286,36021000700
36,021,000700,4,"Block Group 4, Census Tract 7, Columbia County, New York",99,353,452,55,16,0,13,0,15,6,353,452,75,16,66,107,83,99,2002.0,2005.0,2012.0,640.0,803.0,945.0,33.8,48750.0,985,36021000700
36,071,015004,1,"Block Group 1, Census Tract 150.04, Orange County, New York",97,57,154,37,11,0,0,0,49,0,57,154,0,0,26,31,0,97,2001.0,2006.0,2010.0,901.0,1040.0,1219.0,50.0,41719.0,932,36071015004
36,071,015004,2,"Block Group 2, Census Tract 150.04, Orange County, New York",148,119,267,84,22,0,0,7,35,0,119,267,38,11,13,51,6,148,1998.0,2008.0,2012.0,595.0,925.0,1096.0,49.7,25368.0,1318,36071015004
36,071,015004,3,"Block Group 3, Census Tract 150.04, Orange County, New York",591,259,850,259,76,0,11,40,205,0,259,850,34,18,48,66,93,591,2004.0,2010.0,2011.0,833.0,1094.0,1345.0,41.3,45341.0,4756,36071015004
36,071,015005,1,"Block Group 1, Census Tract 150.05, Orange County, New York",265,155,420,191,13,0,0,0,61,0,155,420,5,8,5,83,54,265,2007.0,2011.0,2012.0,903.0,974.0,1436.0,44.1,44583.0,2540,36071015005
36,071,015005,2,"Block Group 2, Census Tract 150.05, Orange County, New York",317,68,385,150,13,0,9,57,88,0,68,385,0,13,24,22,9,317,1999.0,2008.0,2010.0,229.0,615.0,1088.0,43.5,27750.0,2018,36071015005
36,071,015006,1,"Block Group 1, Census Tract 150.06, Orange County, New York",726,177,903,265,45,0,93,7,316,30,177,903,8,17,12,90,20,726,2006.0,2008.0,2008.0,561.0,832.0,1087.0,50.0,20875.0,4670,36071015006
36,071,015006,2,"Block Group 2, Census Tract 150.06, Orange County, New York",145,115,260,59,0,0,0,19,67,0,115,260,0,19,40,43,13,145,2000.0,2005.0,2008.0,657.0,854.0,1061.0,46.9,34290.0,1880,36071015006
36,071,015100,1,"Block Group 1, Census Tract 151, Orange County, New York",319,63,382,209,64,0,15,0,31,0,63,382,0,0,0,63,0,319,,2012.0,2013.0,814.0,890.0,1102.0,50.0,40486.0,656,36071015100
36,071,015100,2,"Block Group 2, Census Tract 151, Orange County, New York",48,230,278,37,0,0,0,0,11,0,230,278,17,9,7,81,116,48,2010.0,2010.0,2012.0,1163.0,864.0,1100.0,42.9,131875.0,864,36071015100
36,071,015100,3,"Block Group 3, Census Tract 151, Orange County, New York",122,427,549,95,27,0,0,0,0,0,427,549,17,0,8,211,191,122,2009.0,2011.0,2013.0,1065.0,1156.0,1248.0,33.6,50020.0,1761,36071015100
36,071,015100,4,"Block Group 4, Census Tract 151, Orange County, New York",155,129,284,132,0,0,0,0,23,0,129,284,11,0,31,77,10,155,2003.0,2010.0,2012.0,464.0,476.0,855.0,34.9,30906.0,792,36071015100
36,071,015100,5,"Block Group 5, Census Tract 151, Orange County, New York",242,161,403,118,11,0,0,96,17,0,161,403,60,11,0,71,19,242,2001.0,2004.0,2010.0,528.0,618.0,816.0,29.6,25067.0,881,36071015100
36,071,015100,6,"Block Group 6, Census Tract 151, Orange County, New York",210,148,358,26,13,0,0,52,119,0,148,358,75,33,16,24,0,210,1979.0,2000.0,2004.0,873.0,1065.0,1158.0,50.0,28705.0,1014,36071015100
36,071,015200,1,"Block Group 1, Census Tract 152, Orange County, New York",162,0,162,130,11,0,0,0,21,0,0,162,0,0,0,0,0,162,,2012.0,2012.0,1349.0,2241.0,2659.0,37.0,41563.0,716,36071015200
36,071,015200,2,"Block Group 2, Census Tract 152, Orange County, New York",40,821,861,40,0,0,0,0,0,61,821,861,32,85,196,356,91,40,2003.0,2003.0,,,,,,114926.0,2403,36071015200
36,071,015200,3,"Block Group 3, Census Tract 152, Orange County, New York",40,119,159,22,18,0,0,0,0,0,119,159,0,0,0,74,45,40,2008.0,2010.0,,,,,,128661.0,791,36071015200
36,071,015200,4,"Block Group 4, Census Tract 152, Orange County, New York",179,247,426,48,60,0,0,0,71,0,247,426,41,53,0,59,94,179,2005.0,2009.0,2012.0,,1087.0,1168.0,44.2,48810.0,825,36071015200
36,071,015200,5,"Block Group 5, Census Tract 152, Orange County, New York",28,425,453,28,0,0,0,0,0,0,425,453,75,59,169,122,0,28,1995.0,1995.0,,,,,,115964.0,1344,36071015200
36,071,015200,6,"Block Group 6, Census Tract 152, Orange County, New York",49,1055,1104,28,0,0,0,14,7,85,1055,1104,24,32,64,578,272,49,2007.0,2007.0,2011.0,808.0,839.0,869.0,31.4,114773.0,4177,36071015200
36,039,080402,1,"Block Group 1, Census Tract 804.02, Greene County, New York",53,511,564,11,0,7,7,12,16,26,511,564,72,71,118,159,65,53,2000.0,2000.0,2000.0,411.0,530.0,906.0,32.5,50577.0,1202,36039080402
36,039,080402,2,"Block Group 2, Census Tract 804.02, Greene County, New York",28,402,430,18,2,0,0,0,8,16,402,430,89,82,70,95,50,28,1994.0,1996.0,2012.0,625.0,690.0,786.0,50.0,53889.0,913,36039080402
36,039,080501,1,"Block Group 1, Census Tract 805.01, Greene County, New York",62,261,323,40,8,3,0,0,11,0,261,323,19,16,117,66,43,62,1998.0,2001.0,2012.0,549.0,737.0,802.0,27.9,56406.0,734,36039080501
36,039,080501,2,"Block Group 2, Census Tract 805.01, Greene County, New York",145,490,635,41,56,3,0,0,45,11,490,635,77,74,81,167,80,145,2001.0,2004.0,2013.0,822.0,899.0,1329.0,41.4,69306.0,1946,36039080501
36,039,080502,1,"Block Group 1, Census Tract 805.02, Greene County, New York",40,426,466,13,0,0,21,0,6,12,426,466,26,80,145,94,69,40,1997.0,1997.0,1990.0,574.0,598.0,771.0,50.0,75531.0,1369,36039080502
36,039,080502,2,"Block Group 2, Census Tract 805.02, Greene County, New York",58,129,187,16,4,0,9,0,29,0,129,187,13,26,0,76,14,58,2003.0,2004.0,2007.0,680.0,775.0,1375.0,50.0,43558.0,650,36039080502
36,039,080502,3,"Block Group 3, Census Tract 805.02, Greene County, New York",165,159,324,112,0,0,0,0,53,48,159,324,5,22,23,51,10,165,2006.0,2010.0,2011.0,,686.0,732.0,50.0,23077.0,792,36039080502
36,039,080502,4,"Block Group 4, Census Tract 805.02, Greene County, New York",100,249,349,75,0,0,18,7,0,20,249,349,36,38,6,98,51,100,2005.0,2007.0,2012.0,416.0,474.0,532.0,43.1,45742.0,992,36039080502
36,039,081101,1,"Block Group 1, Census Tract 811.01, Greene County, New York",190,539,729,41,51,0,0,43,55,18,539,729,119,40,108,189,65,190,2000.0,2002.0,2009.0,638.0,678.0,724.0,31.3,43894.0,1843,36039081101
36,039,081101,2,"Block Group 2, Census Tract 811.01, Greene County, New York",52,322,374,40,12,0,0,0,0,13,322,374,36,97,102,60,14,52,1993.0,1995.0,2013.0,635.0,585.0,841.0,24.3,83750.0,946,36039081101
36,039,081101,3,"Block Group 3, Census Tract 811.01, Greene County, New York",147,388,535,93,10,0,0,0,44,0,388,535,44,81,133,93,37,147,1995.0,2001.0,2012.0,639.0,804.0,997.0,31.5,61010.0,1572,36039081101
36,039,081102,1,"Block Group 1, Census Tract 811.02, Greene County, New York",124,267,391,45,26,0,0,0,53,0,267,391,62,41,109,41,14,124,1993.0,1998.0,2011.0,721.0,817.0,1287.0,45.5,45821.0,1095,36039081102
36,039,081102,2,"Block Group 2, Census Tract 811.02, Greene County, New York",9,119,128,0,0,0,0,0,9,0,119,128,8,8,19,35,49,9,2007.0,2007.0,,,,,,81389.0,457,36039081102
36,039,081102,3,"Block Group 3, Census Tract 811.02, Greene County, New York",88,280,368,53,13,0,0,0,22,0,280,368,44,7,103,104,22,88,1999.0,2002.0,2012.0,861.0,1038.0,1144.0,28.6,58971.0,1112,36039081102
36,079,011000,2,"Block Group 2, Census Tract 110, Putnam County, New York",26,232,258,4,0,0,15,7,0,26,232,258,41,35,24,84,22,26,2002.0,2001.0,1989.0,792.0,844.0,950.0,14.0,122727.0,737,36079011000
36,079,011000,3,"Block Group 3, Census Tract 110, Putnam County, New York",23,290,313,0,0,0,0,0,23,0,290,313,54,39,61,72,64,23,1999.0,2000.0,,,,,,95223.0,783,36079011000
36,079,010200,2,"Block Group 2, Census Tract 102, Putnam County, New York",211,220,431,117,41,0,0,0,53,50,220,431,10,40,49,57,14,211,2002.0,2010.0,2012.0,1073.0,1146.0,1219.0,36.2,61525.0,1357,36079010200
36,079,010200,3,"Block Group 3, Census Tract 102, Putnam County, New York",0,209,209,0,0,0,0,0,0,10,209,209,0,13,121,58,7,0,1998.0,1998.0,,,,,,98173.0,670,36079010200
36,079,010200,1,"Block Group 1, Census Tract 102, Putnam County, New York",105,389,494,30,35,0,0,25,15,16,389,494,68,28,77,138,62,105,2002.0,2003.0,2012.0,926.0,994.0,1367.0,27.1,95804.0,2707,36079010200
36,079,010200,4,"Block Group 4, Census Tract 102, Putnam County, New York",118,593,711,118,0,0,0,0,0,0,593,711,34,118,186,180,75,118,1998.0,2001.0,2012.0,936.0,1052.0,1191.0,50.0,102431.0,2185,36079010200
36,079,010300,4,"Block Group 4, Census Tract 103, Putnam County, New York",138,378,516,52,40,0,0,0,46,0,378,516,122,47,54,93,62,138,1994.0,2003.0,2012.0,1340.0,1430.0,1593.0,29.2,76190.0,1528,36079010300
36,079,010300,3,"Block Group 3, Census Tract 103, Putnam County, New York",48,321,369,37,11,0,0,0,0,9,321,369,43,27,69,116,57,48,2002.0,2004.0,2013.0,1292.0,1392.0,1492.0,18.2,75469.0,949,36079010300
36,079,010300,1,"Block Group 1, Census Tract 103, Putnam County, New York",15,567,582,0,0,0,0,0,15,8,567,582,85,86,110,198,80,15,2000.0,2000.0,,,,,,72941.0,1515,36079010300
36,079,010300,2,"Block Group 2, Census Tract 103, Putnam County, New York",0,256,256,0,0,0,0,0,0,0,256,256,46,57,42,95,16,0,1996.0,1996.0,,,,,,94250.0,698,36079010300
36,079,010600,1,"Block Group 1, Census Tract 106, Putnam County, New York",207,942,1149,83,0,0,15,29,80,7,942,1149,96,142,231,237,229,207,2000.0,2002.0,2007.0,865.0,1394.0,2028.0,35.6,108350.0,3059,36079010600
36,001,014803,2,"Block Group 2, Census Tract 148.03, Albany County, New York",64,661,725,15,0,0,12,10,27,0,661,725,76,116,175,256,38,64,1998.0,1999.0,2004.0,,489.0,605.0,20.0,83107.0,1910,36001014803
36,027,300000,3,"Block Group 3, Census Tract 3000, Dutchess County, New York",282,142,424,182,62,0,0,0,38,0,142,424,28,21,0,93,0,282,2002.0,2011.0,2013.0,872.0,1092.0,1241.0,33.5,56968.0,1346,36027300000
36,027,090000,1,"Block Group 1, Census Tract 900, Dutchess County, New York",71,274,345,37,5,0,6,0,23,8,274,345,72,36,41,73,44,71,1997.0,2002.0,2011.0,656.0,786.0,1369.0,24.5,70982.0,745,36027090000
36,025,971400,1,"Block Group 1, Census Tract 9714, Delaware County, New York",48,356,404,24,8,0,0,0,16,0,356,404,49,27,98,169,13,48,2000.0,2002.0,2012.0,452.0,503.0,542.0,35.3,70263.0,970,36025971400
36,025,971400,2,"Block Group 2, Census Tract 9714, Delaware County, New York",51,193,244,16,14,0,10,0,11,10,193,244,27,28,58,46,24,51,1997.0,2000.0,2011.0,655.0,675.0,695.0,14.1,72750.0,662,36025971400
36,025,971400,3,"Block Group 3, Census Tract 9714, Delaware County, New York",133,203,336,38,38,18,4,10,25,14,203,336,30,26,39,76,18,133,2001.0,2004.0,2011.0,405.0,450.0,552.0,32.1,30068.0,700,36025971400
36,021,000700,5,"Block Group 5, Census Tract 7, Columbia County, New York",135,147,282,71,4,12,0,20,28,0,147,282,43,28,30,26,20,135,1991.0,2001.0,2011.0,564.0,745.0,954.0,29.6,36042.0,747,36021000700
36,021,000800,1,"Block Group 1, Census Tract 8, Columbia County, New York",34,263,297,27,4,0,0,3,0,16,263,297,45,50,66,61,25,34,1996.0,1998.0,2013.0,632.0,1313.0,1677.0,50.0,78036.0,690,36021000800
36,021,000800,2,"Block Group 2, Census Tract 8, Columbia County, New York",95,273,368,13,19,4,19,18,22,3,273,368,43,16,109,77,25,95,1997.0,1998.0,2003.0,502.0,650.0,689.0,28.3,62500.0,800,36021000800
36,021,000900,1,"Block Group 1, Census Tract 9, Columbia County, New York",44,272,316,23,0,0,0,7,14,9,272,316,35,80,43,68,37,44,1995.0,1999.0,2010.0,710.0,860.0,1438.0,31.7,70526.0,854,36021000900
36,021,000900,2,"Block Group 2, Census Tract 9, Columbia County, New York",135,233,368,53,19,0,0,15,48,6,233,368,45,46,39,55,42,135,1997.0,2004.0,2010.0,622.0,718.0,901.0,29.9,46250.0,828,36021000900
36,021,001000,1,"Block Group 1, Census Tract 10, Columbia County, New York",114,296,410,43,16,0,0,38,17,0,296,410,90,9,36,78,83,114,2002.0,2003.0,2010.0,248.0,564.0,634.0,25.6,57917.0,991,36021001000
36,021,001000,2,"Block Group 2, Census Tract 10, Columbia County, New York",108,348,456,46,0,0,0,0,62,64,348,456,69,57,53,32,73,108,1999.0,2005.0,2009.0,628.0,719.0,1103.0,50.0,47311.0,692,36021001000
36,021,001000,3,"Block Group 3, Census Tract 10, Columbia County, New York",228,260,488,105,53,9,0,0,61,17,260,488,146,13,17,50,17,228,1979.0,2005.0,2012.0,606.0,783.0,993.0,27.3,33409.0,975,36021001000
36,021,001000,4,"Block Group 4, Census Tract 10, Columbia County, New York",61,521,582,23,38,0,0,0,0,29,521,582,95,33,84,215,65,61,2002.0,2004.0,,,,,,66806.0,1448,36021001000
36,021,001000,5,"Block Group 5, Census Tract 10, Columbia County, New York",19,277,296,19,0,0,0,0,0,0,277,296,34,0,44,132,67,19,2005.0,2005.0,,,,,,66912.0,595,36021001000
36,021,001000,6,"Block Group 6, Census Tract 10, Columbia County, New York",64,424,488,25,21,0,0,18,0,24,424,488,74,89,0,198,39,64,2002.0,2003.0,2013.0,,,,,36778.0,1123,36021001000
36,021,001100,1,"Block Group 1, Census Tract 11, Columbia County, New York",128,152,280,36,16,7,0,7,62,0,152,280,17,30,60,45,0,128,1995.0,2002.0,2008.0,568.0,640.0,724.0,45.7,53929.0,638,36021001100
36,021,001100,2,"Block Group 2, Census Tract 11, Columbia County, New York",112,330,442,14,52,0,0,8,38,0,330,442,104,50,59,101,16,112,1992.0,2000.0,2014.0,730.0,782.0,913.0,18.9,58227.0,882,36021001100
36,021,001100,3,"Block Group 3, Census Tract 11, Columbia County, New York",132,584,716,66,12,32,0,0,22,18,584,716,126,36,123,208,73,132,2000.0,2002.0,2011.0,781.0,980.0,1125.0,43.4,71912.0,1786,36021001100
36,021,001100,4,"Block Group 4, Census Tract 11, Columbia County, New York",221,200,421,89,26,0,0,15,91,63,200,421,15,15,64,11,32,221,2005.0,2010.0,2010.0,293.0,708.0,770.0,25.0,35156.0,861,36021001100
36,021,001200,1,"Block Group 1, Census Tract 12, Columbia County, New York",196,323,519,52,15,0,0,24,105,16,323,519,36,16,23,145,87,196,2006.0,2006.0,2007.0,783.0,842.0,890.0,32.6,74028.0,1196,36021001200
36,021,001200,2,"Block Group 2, Census Tract 12, Columbia County, New York",413,35,448,226,32,0,0,7,148,0,35,448,0,0,0,35,0,413,,2011.0,2011.0,172.0,230.0,556.0,19.8,26111.0,882,36021001200
36,021,001200,3,"Block Group 3, Census Tract 12, Columbia County, New York",224,86,310,156,32,0,0,0,36,0,86,310,14,5,0,44,23,224,2005.0,2012.0,2012.0,431.0,542.0,942.0,25.0,27009.0,784,36021001200
36,021,001200,4,"Block Group 4, Census Tract 12, Columbia County, New York",149,55,204,71,38,0,7,0,33,0,55,204,0,0,17,28,10,149,2004.0,2011.0,2012.0,518.0,714.0,858.0,25.4,38971.0,472,36021001200
36,021,001300,1,"Block Group 1, Census Tract 13, Columbia County, New York",247,119,366,173,33,0,0,5,36,0,119,366,22,33,0,55,9,247,2001.0,2011.0,2012.0,99.0,461.0,536.0,23.3,26293.0,733,36021001300
36,021,001300,2,"Block Group 2, Census Tract 13, Columbia County, New York",151,59,210,95,9,0,0,0,47,0,59,210,10,0,0,26,23,151,2008.0,2011.0,2012.0,690.0,836.0,1188.0,34.4,68854.0,884,36021001300
36,021,001300,3,"Block Group 3, Census Tract 13, Columbia County, New York",76,76,152,29,0,0,0,0,47,8,76,152,10,9,0,34,15,76,2006.0,2007.0,2008.0,708.0,737.0,900.0,19.2,61167.0,253,36021001300
36,021,001300,4,"Block Group 4, Census Tract 13, Columbia County, New York",119,126,245,68,0,0,0,32,19,15,126,245,63,0,0,38,10,119,1979.0,2005.0,2011.0,,802.0,946.0,24.4,53125.0,535,36021001300
36,021,001300,5,"Block Group 5, Census Tract 13, Columbia County, New York",282,81,363,138,59,0,7,10,68,0,81,363,0,36,0,36,9,282,2001.0,2011.0,2012.0,578.0,819.0,1009.0,32.2,43894.0,713,36021001300
36,021,001400,1,"Block Group 1, Census Tract 14, Columbia County, New York",81,566,647,22,19,6,0,8,26,0,566,647,73,84,142,178,89,81,1999.0,2001.0,2010.0,431.0,524.0,1095.0,18.5,67708.0,1775,36021001400
36,021,001400,2,"Block Group 2, Census Tract 14, Columbia County, New York",177,288,465,107,13,0,0,0,57,35,288,465,23,76,82,61,11,177,1995.0,2004.0,2011.0,703.0,749.0,1238.0,18.7,51027.0,1102,36021001400
36,021,001400,3,"Block Group 3, Census Tract 14, Columbia County, New York",52,265,317,15,0,0,0,0,37,9,265,317,57,12,67,61,59,52,1999.0,2002.0,2007.0,,,,,78688.0,686,36021001400
36,021,001500,1,"Block Group 1, Census Tract 15, Columbia County, New York",40,237,277,27,0,0,0,13,0,3,237,277,17,33,43,84,57,40,2003.0,2004.0,2011.0,721.0,743.0,796.0,50.0,69375.0,669,36021001500
36,021,001500,2,"Block Group 2, Census Tract 15, Columbia County, New York",20,198,218,6,1,6,3,0,4,11,198,218,28,25,43,43,48,20,2001.0,2001.0,2003.0,99.0,638.0,950.0,32.5,75625.0,437,36021001500
36,021,001600,1,"Block Group 1, Census Tract 16, Columbia County, New York",138,408,546,129,0,0,0,0,9,34,408,546,42,54,108,165,5,138,2000.0,2004.0,2012.0,438.0,1058.0,1224.0,10.0,69500.0,1371,36021001600
36,021,001600,2,"Block Group 2, Census Tract 16, Columbia County, New York",124,293,417,77,20,0,9,18,0,0,293,417,19,33,32,190,19,124,2003.0,2005.0,2012.0,675.0,793.0,992.0,20.8,77120.0,1203,36021001600
36,021,001600,3,"Block Group 3, Census Tract 16, Columbia County, New York",69,348,417,20,0,0,0,0,49,6,348,417,74,77,88,74,29,69,1993.0,1997.0,2007.0,756.0,780.0,1284.0,38.0,57656.0,948,36021001600
36,021,001700,1,"Block Group 1, Census Tract 17, Columbia County, New York",71,206,277,34,12,3,0,0,22,0,206,277,53,34,48,59,12,71,1993.0,2000.0,2012.0,825.0,871.0,1148.0,27.9,80568.0,620,36021001700
36,021,001700,2,"Block Group 2, Census Tract 17, Columbia County, New York",82,221,303,32,0,14,0,0,36,4,221,303,36,21,33,105,22,82,2002.0,2003.0,2008.0,544.0,1109.0,1433.0,19.2,65234.0,710,36021001700
36,001,014302,3,"Block Group 3, Census Tract 143.02, Albany County, New York",66,614,680,16,32,0,0,0,18,38,614,680,18,63,190,214,91,66,2002.0,2003.0,2015.0,1521.0,1757.0,1993.0,41.2,111250.0,1798,36001014302
36,001,014302,4,"Block Group 4, Census Tract 143.02, Albany County, New York",233,605,838,77,11,0,54,16,75,16,605,838,74,148,116,138,113,233,1997.0,2001.0,2006.0,99.0,1060.0,1289.0,14.5,90967.0,2422,36001014302
36,001,014401,2,"Block Group 2, Census Tract 144.01, Albany County, New York",224,437,661,117,9,0,0,0,98,10,437,661,61,58,82,148,78,224,2001.0,2005.0,2011.0,575.0,604.0,797.0,25.2,62153.0,1416,36001014401
36,111,950100,4,"Block Group 4, Census Tract 9501, Ulster County, New York",41,261,302,28,0,0,0,13,0,14,261,302,30,43,59,77,38,41,2000.0,2001.0,2011.0,,,,50.0,109000.0,815,36111950100
36,111,950100,5,"Block Group 5, Census Tract 9501, Ulster County, New York",58,339,397,29,0,14,0,15,0,0,339,397,56,15,71,182,15,58,2002.0,2002.0,2005.0,751.0,807.0,854.0,27.4,67036.0,1268,36111950100
36,111,950200,2,"Block Group 2, Census Tract 9502, Ulster County, New York",241,380,621,157,19,9,0,0,56,35,380,621,79,38,63,138,27,241,2001.0,2006.0,2012.0,541.0,888.0,1075.0,44.8,44871.0,1576,36111950200
36,111,950200,3,"Block Group 3, Census Tract 9502, Ulster County, New York",349,129,478,193,65,0,0,17,74,0,129,478,36,24,22,40,7,349,1992.0,2011.0,2012.0,666.0,795.0,943.0,35.5,37276.0,1111,36111950200
36,111,950200,1,"Block Group 1, Census Tract 9502, Ulster County, New York",331,325,656,162,59,0,26,0,84,8,325,656,43,43,116,66,49,331,1997.0,2007.0,2012.0,682.0,835.0,956.0,47.5,38182.0,1207,36111950200
36,111,950900,2,"Block Group 2, Census Tract 9509, Ulster County, New York",20,233,253,1,6,6,0,0,7,25,233,253,35,42,49,51,31,20,1998.0,1999.0,2006.0,706.0,720.0,735.0,14.1,57212.0,542,36111950900
36,111,952300,1,"Block Group 1, Census Tract 9523, Ulster County, New York",243,49,292,71,32,0,13,20,107,0,49,292,12,6,0,25,6,243,2003.0,2007.0,2008.0,945.0,1053.0,1171.0,31.2,52667.0,608,36111952300
36,111,952300,2,"Block Group 2, Census Tract 9523, Ulster County, New York",283,213,496,163,79,0,0,8,33,0,213,496,42,30,34,55,52,283,2000.0,2011.0,2013.0,773.0,887.0,1078.0,33.7,49643.0,1077,36111952300
36,111,953500,3,"Block Group 3, Census Tract 9535, Ulster County, New York",95,263,358,53,33,0,0,0,9,10,263,358,60,32,65,46,50,95,1996.0,2004.0,2014.0,1056.0,1146.0,1236.0,39.6,81250.0,974,36111953500
36,111,953500,1,"Block Group 1, Census Tract 9535, Ulster County, New York",264,46,310,156,92,0,0,0,16,0,46,310,25,6,7,8,0,264,1979.0,2013.0,2014.0,1013.0,1123.0,1232.0,38.1,38400.0,738,36111953500
36,111,953500,2,"Block Group 2, Census Tract 9535, Ulster County, New York",190,54,244,103,66,0,0,0,21,0,54,244,25,10,7,12,0,190,1982.0,2012.0,2014.0,1066.0,1339.0,1632.0,43.0,32075.0,3676,36111953500
36,111,953700,3,"Block Group 3, Census Tract 9537, Ulster County, New York",116,270,386,66,11,0,0,8,31,12,270,386,5,44,15,140,54,116,2005.0,2007.0,2011.0,744.0,1054.0,1152.0,47.3,61087.0,968,36111953700
36,111,953700,1,"Block Group 1, Census Tract 9537, Ulster County, New York",70,561,631,16,21,0,0,0,33,14,561,631,109,50,100,215,73,70,2001.0,2002.0,2011.0,730.0,1188.0,1359.0,17.5,100069.0,1947,36111953700
36,111,953700,2,"Block Group 2, Census Tract 9537, Ulster County, New York",219,335,554,90,19,0,6,17,87,13,335,554,16,37,82,98,89,219,2003.0,2006.0,2010.0,744.0,894.0,1134.0,23.5,65625.0,1640,36111953700
36,111,953700,4,"Block Group 4, Census Tract 9537, Ulster County, New York",49,226,275,7,8,0,0,14,20,0,226,275,37,31,69,72,17,49,1997.0,1998.0,2005.0,529.0,775.0,906.0,36.5,73661.0,641,36111953700
36,111,953900,2,"Block Group 2, Census Tract 9539, Ulster County, New York",158,733,891,53,0,0,0,0,105,11,733,891,128,147,172,207,68,158,1995.0,2000.0,2008.0,781.0,1029.0,1170.0,22.6,90950.0,2376,36111953900
36,111,953900,1,"Block Group 1, Census Tract 9539, Ulster County, New York",222,325,547,69,62,0,0,10,81,8,325,547,45,43,124,65,40,222,1996.0,2004.0,2011.0,776.0,940.0,1277.0,25.3,75703.0,1529,36111953900
36,111,953900,3,"Block Group 3, Census Tract 9539, Ulster County, New York",93,294,387,26,0,42,0,25,0,24,294,387,28,73,84,53,32,93,1995.0,1995.0,1992.0,542.0,626.0,856.0,27.5,104196.0,1041,36111953900
36,111,954100,1,"Block Group 1, Census Tract 9541, Ulster County, New York",141,252,393,50,9,0,0,37,45,0,252,393,43,37,92,50,30,141,1995.0,1999.0,2007.0,543.0,834.0,971.0,37.4,59648.0,1137,36111954100
36,111,954100,4,"Block Group 4, Census Tract 9541, Ulster County, New York",101,233,334,53,16,0,22,0,10,56,233,334,0,36,63,33,45,101,2005.0,2010.0,2012.0,689.0,1012.0,1131.0,29.2,49375.0,1112,36111954100
36,111,954100,2,"Block Group 2, Census Tract 9541, Ulster County, New York",60,596,656,23,16,0,0,0,21,41,596,656,52,67,69,249,118,60,2004.0,2005.0,2012.0,686.0,716.0,741.0,28.4,56250.0,1804,36111954100
36,111,954100,3,"Block Group 3, Census Tract 9541, Ulster County, New York",111,348,459,38,50,0,0,0,23,31,348,459,52,79,84,58,44,111,1995.0,2002.0,2014.0,866.0,980.0,1112.0,31.5,60938.0,1238,36111954100
36,111,955000,1,"Block Group 1, Census Tract 9550, Ulster County, New York",147,296,443,17,0,27,0,0,103,0,296,443,38,31,42,141,44,147,2003.0,2003.0,2005.0,612.0,641.0,840.0,50.0,50284.0,1473,36111955000
36,083,052501,4,"Block Group 4, Census Tract 525.01, Rensselaer County, New York",150,594,744,27,63,0,0,43,17,20,594,744,38,78,154,206,98,150,2001.0,2003.0,2013.0,459.0,677.0,760.0,50.0,64490.0,2005,36083052501
36,083,052502,4,"Block Group 4, Census Tract 525.02, Rensselaer County, New York",150,176,326,111,21,0,0,0,18,19,176,326,32,0,25,71,29,150,2004.0,2011.0,2013.0,1355.0,1299.0,1592.0,23.6,73942.0,840,36083052502
36,027,140602,2,"Block Group 2, Census Tract 1406.02, Dutchess County, New York",43,468,511,0,32,11,0,0,0,0,468,511,102,39,47,202,78,43,2002.0,2003.0,,,,,,80729.0,1256,36027140602
36,027,140500,2,"Block Group 2, Census Tract 1405, Dutchess County, New York",24,351,375,12,12,0,0,0,0,21,351,375,57,8,66,106,93,24,2004.0,2005.0,,,,,,123218.0,1282,36027140500
36,027,140500,3,"Block Group 3, Census Tract 1405, Dutchess County, New York",237,15,252,193,39,0,0,0,5,0,15,252,0,0,0,0,15,237,,2015.0,2015.0,1046.0,1173.0,1430.0,28.9,63043.0,460,36027140500
36,027,140602,1,"Block Group 1, Census Tract 1406.02, Dutchess County, New York",111,449,560,37,34,0,12,19,9,27,449,560,100,9,107,171,35,111,2000.0,2002.0,2012.0,1088.0,1176.0,1326.0,21.0,82500.0,1621,36027140602
36,027,140700,4,"Block Group 4, Census Tract 1407, Dutchess County, New York",77,707,784,0,24,0,0,0,53,0,707,784,136,85,72,251,163,77,2002.0,2003.0,,,,,,91514.0,2510,36027140700
36,027,140700,5,"Block Group 5, Census Tract 1407, Dutchess County, New York",18,297,315,18,0,0,0,0,0,23,297,315,109,52,49,17,47,18,1988.0,1989.0,,,,,,111047.0,823,36027140700
36,027,140801,1,"Block Group 1, Census Tract 1408.01, Dutchess County, New York",8,164,172,8,0,0,0,0,0,15,164,172,0,20,25,29,75,8,2011.0,2011.0,,,,,,100556.0,579,36027140801
36,027,140801,2,"Block Group 2, Census Tract 1408.01, Dutchess County, New York",36,465,501,27,0,0,0,0,9,12,465,501,99,73,90,140,51,36,1997.0,1999.0,2012.0,,,,,107458.0,1389,36027140801
36,027,140801,3,"Block Group 3, Census Tract 1408.01, Dutchess County, New York",24,278,302,11,0,0,0,0,13,0,278,302,99,0,44,60,75,24,1999.0,2001.0,1999.0,809.0,857.0,908.0,,81579.0,813,36027140801
36,027,150003,1,"Block Group 1, Census Tract 1500.03, Dutchess County, New York",216,238,454,102,55,0,3,3,53,33,238,454,12,40,43,64,46,216,2004.0,2010.0,2012.0,713.0,1093.0,1737.0,49.0,45294.0,1018,36027150003
36,027,150003,2,"Block Group 2, Census Tract 1500.03, Dutchess County, New York",48,129,177,0,13,0,0,26,9,0,129,177,34,23,20,31,21,48,1994.0,1997.0,1999.0,379.0,1050.0,1344.0,16.7,95938.0,1146,36027150003
36,027,150003,3,"Block Group 3, Census Tract 1500.03, Dutchess County, New York",25,10,35,6,5,4,0,0,10,0,10,35,0,0,10,0,0,25,,2004.0,2009.0,1082.0,1164.0,1625.0,15.4,146042.0,908,36027150003
36,027,150004,1,"Block Group 1, Census Tract 1500.04, Dutchess County, New York",132,840,972,63,29,0,0,21,19,35,840,972,122,66,196,293,128,132,2001.0,2003.0,2012.0,906.0,1103.0,1529.0,27.5,86413.0,2660,36027150004
36,027,150004,2,"Block Group 2, Census Tract 1500.04, Dutchess County, New York",100,235,335,59,10,0,0,31,0,9,235,335,32,70,57,60,7,100,1993.0,1997.0,2012.0,1202.0,1656.0,1861.0,31.6,95694.0,804,36027150004
36,027,150005,1,"Block Group 1, Census Tract 1500.05, Dutchess County, New York",128,404,532,22,66,0,0,9,31,26,404,532,79,25,30,192,52,128,2004.0,2006.0,2016.0,647.0,811.0,948.0,47.3,54074.0,1338,36027150005
36,027,150005,2,"Block Group 2, Census Tract 1500.05, Dutchess County, New York",95,418,513,35,17,0,0,36,7,40,418,513,37,91,120,115,15,95,1997.0,1998.0,2011.0,723.0,1069.0,1694.0,16.9,97708.0,1343,36027150005
36,027,150006,1,"Block Group 1, Census Tract 1500.06, Dutchess County, New York",156,268,424,82,24,0,5,0,45,0,268,424,23,32,52,118,43,156,2002.0,2006.0,2012.0,560.0,783.0,1269.0,37.4,66000.0,974,36027150006
36,111,951500,2,"Block Group 2, Census Tract 9515, Ulster County, New York",35,282,317,25,0,0,0,10,0,0,282,317,98,31,46,69,38,35,1993.0,1995.0,2012.0,951.0,1257.0,1378.0,27.8,59598.0,728,36111951500
36,111,951500,3,"Block Group 3, Census Tract 9515, Ulster County, New York",51,396,447,16,14,1,5,5,10,7,396,447,71,73,74,121,50,51,1997.0,1999.0,2011.0,813.0,920.0,1125.0,19.4,74792.0,1055,36111951500
36,111,951500,1,"Block Group 1, Census Tract 9515, Ulster County, New York",18,199,217,9,9,0,0,0,0,10,199,217,53,11,13,75,37,18,2003.0,2004.0,2008.0,593.0,631.0,1333.0,32.9,55329.0,528,36111951500
36,111,951500,4,"Block Group 4, Census Tract 9515, Ulster County, New York",103,318,421,38,10,0,9,10,36,8,318,421,65,21,55,141,28,103,2001.0,2003.0,2009.0,790.0,865.0,995.0,24.8,73250.0,1123,36111951500
36,083,052501,3,"Block Group 3, Census Tract 525.01, Rensselaer County, New York",148,473,621,84,48,0,0,0,16,0,473,621,112,69,102,167,23,148,1995.0,2002.0,2013.0,956.0,1364.0,1513.0,23.4,90160.0,1693,36083052501
36,083,052501,2,"Block Group 2, Census Tract 525.01, Rensselaer County, New York",34,413,447,12,0,0,22,0,0,49,413,447,100,80,86,60,38,34,1993.0,1993.0,2011.0,,1342.0,1471.0,18.1,66875.0,1166,36083052501
36,083,052501,1,"Block Group 1, Census Tract 525.01, Rensselaer County, New York",184,409,593,35,136,0,0,0,13,12,409,593,55,32,129,110,71,184,1999.0,2007.0,2016.0,701.0,788.0,1049.0,24.1,73914.0,1321,36083052501
36,083,052601,1,"Block Group 1, Census Tract 526.01, Rensselaer County, New York",133,571,704,36,39,14,21,0,23,31,571,704,111,103,105,127,94,133,1997.0,2000.0,2011.0,643.0,865.0,981.0,39.0,83214.0,1836,36083052601
36,083,052601,2,"Block Group 2, Census Tract 526.01, Rensselaer County, New York",121,656,777,86,4,9,7,0,15,35,656,777,83,125,151,180,82,121,1998.0,2001.0,2012.0,813.0,917.0,1157.0,32.2,68456.0,1995,36083052601
36,083,052602,1,"Block Group 1, Census Tract 526.02, Rensselaer County, New York",160,272,432,81,14,8,0,19,38,20,272,432,52,31,38,60,71,160,2003.0,2007.0,2011.0,524.0,676.0,833.0,21.5,67308.0,1010,36083052602
36,001,014803,1,"Block Group 1, Census Tract 148.03, Albany County, New York",80,518,598,23,15,0,0,0,42,0,518,598,80,85,118,141,94,80,1998.0,2001.0,2010.0,338.0,519.0,830.0,43.7,64231.0,1471,36001014803
36,021,001800,1,"Block Group 1, Census Tract 18, Columbia County, New York",61,269,330,33,4,0,2,0,22,7,269,330,52,40,95,61,14,61,1994.0,1997.0,2011.0,728.0,826.0,946.0,42.3,56136.0,733,36021001800
36,021,001800,2,"Block Group 2, Census Tract 18, Columbia County, New York",47,315,362,30,0,3,0,5,9,0,315,362,51,45,44,123,52,47,2001.0,2003.0,2011.0,678.0,836.0,980.0,37.2,74375.0,952,36021001800
36,021,001900,1,"Block Group 1, Census Tract 19, Columbia County, New York",52,327,379,24,0,0,0,3,25,3,327,379,23,55,32,156,58,52,2003.0,2004.0,2009.0,719.0,794.0,1063.0,16.8,81563.0,1071,36021001900
36,021,001900,2,"Block Group 2, Census Tract 19, Columbia County, New York",63,265,328,24,13,7,0,6,13,16,265,328,27,43,32,98,49,63,2003.0,2004.0,2011.0,588.0,1072.0,1234.0,31.3,77083.0,957,36021001900
36,021,002000,1,"Block Group 1, Census Tract 20, Columbia County, New York",79,282,361,29,25,6,7,12,0,6,282,361,38,53,58,86,41,79,1999.0,2001.0,2013.0,645.0,791.0,979.0,22.5,63542.0,815,36021002000
36,021,002000,2,"Block Group 2, Census Tract 20, Columbia County, New York",112,327,439,26,22,0,0,0,64,24,327,439,57,64,45,93,44,112,1999.0,2003.0,2009.0,606.0,776.0,1235.0,28.7,77083.0,1068,36021002000
36,111,950600,1,"Block Group 1, Census Tract 9506, Ulster County, New York",71,314,385,45,26,0,0,0,0,0,314,385,55,50,54,91,64,71,2000.0,2004.0,2014.0,928.0,956.0,985.0,50.0,63897.0,666,36111950600
36,111,950600,3,"Block Group 3, Census Tract 9506, Ulster County, New York",100,371,471,52,17,0,12,6,13,0,371,471,89,71,127,77,7,100,1992.0,1995.0,2012.0,725.0,807.0,1027.0,23.8,73650.0,922,36111950600
36,111,950600,2,"Block Group 2, Census Tract 9506, Ulster County, New York",64,459,523,10,0,0,26,0,28,15,459,523,58,111,59,132,84,64,2000.0,2000.0,2002.0,922.0,959.0,980.0,51.0,104107.0,1055,36111950600
36,027,220201,2,"Block Group 2, Census Tract 2202.01, Dutchess County, New York",261,59,320,89,77,0,21,25,49,0,59,320,14,0,22,23,0,261,1997.0,2010.0,2012.0,725.0,1012.0,1227.0,47.1,34327.0,767,36027220201
36,027,220201,3,"Block Group 3, Census Tract 2202.01, Dutchess County, New York",204,58,262,62,44,14,17,26,41,0,58,262,23,21,8,0,6,204,1983.0,2005.0,2010.0,936.0,1059.0,1186.0,50.0,31983.0,1142,36027220201
36,027,220201,4,"Block Group 4, Census Tract 2202.01, Dutchess County, New York",163,109,272,72,27,0,0,12,52,7,109,272,22,20,13,21,26,163,2000.0,2009.0,2011.0,761.0,1018.0,1221.0,35.8,51000.0,822,36027220201
36,027,220300,3,"Block Group 3, Census Tract 2203, Dutchess County, New York",271,84,355,163,49,8,0,23,28,0,84,355,5,35,7,0,37,271,1993.0,2012.0,2012.0,743.0,962.0,1220.0,50.0,27112.0,1028,36027220300
36,027,220300,4,"Block Group 4, Census Tract 2203, Dutchess County, New York",233,69,302,97,92,0,0,15,29,0,69,302,8,0,10,38,13,233,2004.0,2012.0,2014.0,826.0,881.0,1108.0,50.0,28056.0,869,36027220300
36,027,220801,1,"Block Group 1, Census Tract 2208.01, Dutchess County, New York",246,204,450,167,25,0,0,20,34,13,204,450,27,20,17,86,41,246,2004.0,2011.0,2012.0,1012.0,1132.0,1259.0,35.0,83542.0,924,36027220801
36,027,220801,2,"Block Group 2, Census Tract 2208.01, Dutchess County, New York",214,9,223,196,0,0,0,0,18,0,9,223,9,0,0,0,0,214,,2013.0,2013.0,693.0,797.0,1048.0,36.5,36094.0,667,36027220801
36,027,220801,3,"Block Group 3, Census Tract 2208.01, Dutchess County, New York",182,182,364,75,52,0,0,0,55,0,182,364,55,14,29,35,49,182,1998.0,2009.0,2012.0,543.0,922.0,1109.0,50.0,38214.0,784,36027220801
36,027,220801,4,"Block Group 4, Census Tract 2208.01, Dutchess County, New York",265,45,310,151,55,0,0,22,37,0,45,310,0,6,19,6,14,265,1999.0,2012.0,2012.0,694.0,827.0,969.0,50.0,27250.0,593,36027220801
36,027,220801,5,"Block Group 5, Census Tract 2208.01, Dutchess County, New York",201,107,308,133,26,0,0,7,35,5,107,308,8,0,3,28,63,201,2011.0,2012.0,2012.0,1034.0,1145.0,1268.0,26.2,55000.0,833,36027220801
36,027,220901,1,"Block Group 1, Census Tract 2209.01, Dutchess County, New York",159,298,457,44,74,0,0,0,41,0,298,457,81,9,156,28,24,159,1994.0,1999.0,2014.0,1040.0,1113.0,1186.0,24.1,67159.0,1078,36027220901
36,027,220901,2,"Block Group 2, Census Tract 2209.01, Dutchess County, New York",237,66,303,144,28,0,0,27,38,16,66,303,0,21,0,16,13,237,2008.0,2012.0,2012.0,746.0,968.0,1096.0,50.0,26809.0,623,36027220901
36,027,220901,3,"Block Group 3, Census Tract 2209.01, Dutchess County, New York",122,87,209,33,0,0,0,0,89,0,87,209,16,24,0,24,23,122,2001.0,2006.0,2007.0,784.0,951.0,1026.0,29.8,45705.0,642,36027220901
36,027,220901,4,"Block Group 4, Census Tract 2209.01, Dutchess County, New York",274,300,574,150,9,0,13,17,85,0,300,574,58,26,16,170,30,274,2003.0,2006.0,2011.0,875.0,1031.0,1440.0,29.1,49926.0,1667,36027220901
36,027,221001,1,"Block Group 1, Census Tract 2210.01, Dutchess County, New York",81,354,435,29,26,0,0,9,17,17,354,435,35,36,27,131,108,81,2006.0,2007.0,2013.0,1205.0,1591.0,1795.0,20.9,89931.0,957,36027221001
36,027,221001,2,"Block Group 2, Census Tract 2210.01, Dutchess County, New York",58,331,389,32,0,0,0,0,26,17,331,389,65,26,66,93,64,58,2001.0,2003.0,2010.0,981.0,1098.0,1208.0,37.5,50298.0,733,36027221001
36,027,221001,3,"Block Group 3, Census Tract 2210.01, Dutchess County, New York",42,443,485,42,0,0,0,0,0,6,443,485,33,54,140,188,22,42,2000.0,2001.0,2013.0,1537.0,1691.0,1846.0,35.0,83969.0,1120,36027221001
36,027,221001,4,"Block Group 4, Census Tract 2210.01, Dutchess County, New York",27,397,424,0,0,0,0,27,0,10,397,424,18,111,136,67,55,27,1995.0,1995.0,,,,,,76250.0,872,36027221001
36,027,221100,1,"Block Group 1, Census Tract 2211, Dutchess County, New York",737,63,800,337,145,14,11,36,194,0,63,800,14,6,11,0,32,737,2010.0,2012.0,2012.0,761.0,878.0,1091.0,38.9,32596.0,1654,36027221100
36,027,221100,2,"Block Group 2, Census Tract 2211, Dutchess County, New York",262,58,320,186,39,0,0,0,37,11,58,320,14,0,14,19,0,262,2001.0,2012.0,2013.0,798.0,959.0,1202.0,41.8,39318.0,1243,36027221100
36,027,221100,3,"Block Group 3, Census Tract 2211, Dutchess County, New York",222,166,388,141,0,0,10,0,71,24,166,388,27,10,22,65,18,222,2004.0,2009.0,2011.0,808.0,929.0,988.0,49.4,32188.0,1206,36027221100
36,027,410000,2,"Block Group 2, Census Tract 4100, Dutchess County, New York",94,346,440,17,59,0,0,0,18,4,346,440,91,35,52,127,37,94,1999.0,2003.0,2016.0,990.0,1077.0,1163.0,10.0,83167.0,1215,36027410000
36,027,410000,3,"Block Group 3, Census Tract 4100, Dutchess County, New York",261,23,284,105,72,0,6,6,72,6,23,284,6,0,0,5,6,261,2010.0,2012.0,2012.0,909.0,972.0,1163.0,32.2,47670.0,796,36027410000
36,027,140700,1,"Block Group 1, Census Tract 1407, Dutchess County, New York",220,468,688,79,0,0,0,0,141,0,468,688,83,72,192,69,52,220,1994.0,2000.0,2008.0,1017.0,1102.0,1187.0,45.0,70441.0,1612,36027140700
36,027,140700,2,"Block Group 2, Census Tract 1407, Dutchess County, New York",0,233,233,0,0,0,0,0,0,61,233,233,52,19,0,39,62,0,2011.0,2011.0,,,,,,102708.0,484,36027140700
36,027,140700,3,"Block Group 3, Census Tract 1407, Dutchess County, New York",14,403,417,0,0,14,0,0,0,34,403,417,41,37,108,110,73,14,2001.0,2001.0,,,,,,102621.0,1113,36027140700
36,111,954200,2,"Block Group 2, Census Tract 9542, Ulster County, New York",185,632,817,114,0,0,13,0,58,13,632,817,72,15,370,99,63,185,1996.0,1998.0,2011.0,847.0,1053.0,1193.0,37.5,57092.0,1837,36111954200
36,111,954500,3,"Block Group 3, Census Tract 9545, Ulster County, New York",96,317,413,24,19,0,0,29,24,0,317,413,78,7,73,138,21,96,2000.0,2001.0,2008.0,344.0,484.0,745.0,19.3,54141.0,975,36111954500
36,111,954500,4,"Block Group 4, Census Tract 9545, Ulster County, New York",37,170,207,19,0,0,0,0,18,0,170,207,9,23,48,39,51,37,2001.0,2004.0,2011.0,436.0,,,37.5,66964.0,432,36111954500
36,111,954500,1,"Block Group 1, Census Tract 9545, Ulster County, New York",149,259,408,81,33,0,0,8,27,18,259,408,40,0,33,99,69,149,2006.0,2010.0,2012.0,624.0,724.0,847.0,44.8,38000.0,1003,36111954500
36,111,954500,2,"Block Group 2, Census Tract 9545, Ulster County, New York",43,156,199,0,0,21,0,22,0,8,156,199,37,25,16,19,51,43,2000.0,1994.0,,,,,,53810.0,2049,36111954500
36,111,952100,1,"Block Group 1, Census Tract 9521, Ulster County, New York",155,152,307,73,39,0,9,8,26,37,152,307,30,17,28,40,0,155,2000.0,2009.0,2012.0,836.0,1015.0,1202.0,32.3,59531.0,841,36111952100
36,111,952100,2,"Block Group 2, Census Tract 9521, Ulster County, New York",281,37,318,203,11,19,0,0,48,0,37,318,0,0,15,13,9,281,2003.0,2012.0,2012.0,818.0,895.0,1108.0,37.8,41250.0,1100,36111952100
36,111,952100,4,"Block Group 4, Census Tract 9521, Ulster County, New York",154,201,355,82,42,0,0,11,19,19,201,355,25,0,17,59,81,154,2010.0,2011.0,2013.0,643.0,750.0,786.0,34.2,58224.0,805,36111952100
36,111,952100,3,"Block Group 3, Census Tract 9521, Ulster County, New York",160,174,334,44,75,8,0,9,24,0,174,334,38,22,18,53,43,160,2002.0,2009.0,2014.0,639.0,761.0,1168.0,39.3,30000.0,947,36111952100
36,071,000100,2,"Block Group 2, Census Tract 1, Orange County, New York",85,186,271,59,0,0,0,21,5,33,186,271,16,10,0,77,50,85,2009.0,2010.0,2011.0,887.0,970.0,1118.0,47.9,38750.0,674,36071000100
36,071,000100,3,"Block Group 3, Census Tract 1, Orange County, New York",280,160,440,128,95,0,0,25,32,11,160,440,30,15,10,85,9,280,2003.0,2011.0,2013.0,936.0,1035.0,1187.0,32.6,44783.0,1556,36071000100
36,071,000100,1,"Block Group 1, Census Tract 1, Orange County, New York",102,244,346,58,20,0,0,17,7,0,244,346,61,11,59,89,24,102,1998.0,2003.0,2012.0,817.0,867.0,1213.0,41.5,72000.0,1077,36071000100
36,071,000400,1,"Block Group 1, Census Tract 4, Orange County, New York",188,200,388,118,34,0,0,0,36,19,200,388,22,8,52,66,33,188,2003.0,2010.0,2012.0,873.0,1129.0,1316.0,36.7,90200.0,817,36071000400
36,071,000400,3,"Block Group 3, Census Tract 4, Orange County, New York",278,14,292,168,23,20,0,67,0,0,14,292,0,0,0,0,14,278,,2012.0,2012.0,634.0,795.0,870.0,50.0,21058.0,602,36071000400
36,071,000400,2,"Block Group 2, Census Tract 4, Orange County, New York",435,20,455,157,36,22,24,61,135,0,20,455,0,0,0,10,10,435,2010.0,2008.0,2008.0,360.0,743.0,907.0,33.2,15428.0,919,36071000400
36,071,000400,4,"Block Group 4, Census Tract 4, Orange County, New York",217,63,280,84,49,16,0,31,37,26,63,280,0,0,0,16,21,217,2014.0,2012.0,2011.0,441.0,818.0,1020.0,50.0,26132.0,1071,36071000400
36,071,000400,5,"Block Group 5, Census Tract 4, Orange County, New York",224,28,252,128,33,0,0,0,63,0,28,252,9,0,19,0,0,224,,2011.0,2012.0,608.0,832.0,892.0,50.0,20804.0,703,36071000400
36,071,000600,1,"Block Group 1, Census Tract 6, Orange County, New York",190,281,471,93,29,0,0,0,68,60,281,471,72,38,22,71,18,190,2001.0,2007.0,2011.0,872.0,965.0,1096.0,50.0,70649.0,1371,36071000600
36,071,000600,2,"Block Group 2, Census Tract 6, Orange County, New York",622,14,636,324,6,0,12,140,140,0,14,636,0,0,14,0,0,622,,2010.0,2010.0,402.0,904.0,1153.0,50.0,12432.0,1992,36071000600
36,071,000600,3,"Block Group 3, Census Tract 6, Orange County, New York",252,26,278,222,0,9,0,0,21,26,26,278,0,0,0,0,0,252,,2012.0,2012.0,800.0,947.0,1096.0,50.0,16727.0,962,36071000600
36,071,001500,2,"Block Group 2, Census Tract 15, Orange County, New York",351,495,846,197,14,0,0,22,118,11,495,846,63,10,95,234,82,351,2003.0,2007.0,2011.0,891.0,1050.0,1554.0,36.2,71818.0,2081,36071001500
36,071,001500,3,"Block Group 3, Census Tract 15, Orange County, New York",263,180,443,144,25,0,0,9,85,25,180,443,9,12,12,60,62,263,2010.0,2011.0,2011.0,415.0,530.0,843.0,36.5,23194.0,1309,36071001500
36,071,001500,1,"Block Group 1, Census Tract 15, Orange County, New York",376,194,570,183,13,0,0,76,104,0,194,570,31,19,54,34,56,376,1999.0,2008.0,2010.0,803.0,958.0,1209.0,36.5,46371.0,1579,36071001500
36,071,011200,2,"Block Group 2, Census Tract 112, Orange County, New York",132,214,346,74,0,7,0,0,51,6,214,346,11,22,39,81,55,132,2004.0,2007.0,2011.0,709.0,1340.0,1694.0,50.0,31818.0,969,36071011200
36,071,011200,1,"Block Group 1, Census Tract 112, Orange County, New York",112,300,412,75,0,0,0,0,37,37,300,412,48,9,6,104,96,112,2008.0,2010.0,2011.0,1029.0,1103.0,1176.0,16.3,85904.0,1463,36071011200
36,071,011200,3,"Block Group 3, Census Tract 112, Orange County, New York",303,518,821,143,44,7,0,0,109,14,518,821,45,55,66,281,57,303,2003.0,2006.0,2011.0,1173.0,1350.0,1481.0,40.4,64918.0,1959,36071011200
36,111,955000,3,"Block Group 3, Census Tract 9550, Ulster County, New York",70,255,325,0,15,0,0,0,55,0,255,325,33,53,15,143,11,70,2002.0,2003.0,2006.0,519.0,,,51.0,59250.0,549,36111955000
36,111,955000,4,"Block Group 4, Census Tract 9550, Ulster County, New York",116,623,739,52,21,0,43,0,0,0,623,739,87,17,168,288,63,116,2001.0,2002.0,2011.0,423.0,,844.0,,71875.0,1699,36111955000
36,111,955000,2,"Block Group 2, Census Tract 9550, Ulster County, New York",219,543,762,131,17,0,19,0,52,22,543,762,56,174,78,183,30,219,1995.0,2002.0,2011.0,669.0,758.0,1082.0,22.4,62826.0,1626,36111955000
36,027,180001,4,"Block Group 4, Census Tract 1800.01, Dutchess County, New York",19,370,389,10,0,0,0,9,0,0,370,389,10,87,101,128,44,19,1999.0,1999.0,,,,,,95139.0,1054,36027180001
36,027,190101,1,"Block Group 1, Census Tract 1901.01, Dutchess County, New York",21,369,390,0,8,0,0,0,13,0,369,390,35,109,118,107,0,21,1993.0,1994.0,,,,,,108846.0,1224,36027190101
36,027,190101,2,"Block Group 2, Census Tract 1901.01, Dutchess County, New York",7,448,455,0,7,0,0,0,0,28,448,455,77,54,188,53,48,7,1995.0,1995.0,,,,,,96607.0,1234,36027190101
36,027,150006,2,"Block Group 2, Census Tract 1500.06, Dutchess County, New York",254,155,409,117,81,5,8,34,9,9,155,409,29,29,24,42,22,254,1998.0,2011.0,2013.0,709.0,879.0,1094.0,41.5,47768.0,1047,36027150006
36,027,160003,1,"Block Group 1, Census Tract 1600.03, Dutchess County, New York",73,334,407,50,0,0,0,11,12,0,334,407,12,39,67,150,66,73,2003.0,2005.0,2011.0,723.0,1221.0,1737.0,27.2,87625.0,1258,36027160003
36,027,160003,2,"Block Group 2, Census Tract 1600.03, Dutchess County, New York",72,107,179,47,7,0,0,0,18,5,107,179,19,7,39,34,3,72,1997.0,2005.0,2012.0,714.0,822.0,873.0,24.8,58188.0,476,36027160003
36,027,160003,3,"Block Group 3, Census Tract 1600.03, Dutchess County, New York",71,292,363,28,6,0,18,0,19,5,292,363,20,71,31,92,73,71,2003.0,2004.0,2009.0,1084.0,1539.0,1816.0,42.8,94375.0,930,36027160003
36,027,160004,1,"Block Group 1, Census Tract 1600.04, Dutchess County, New York",94,311,405,70,10,0,0,0,14,12,311,405,46,69,36,108,40,94,2000.0,2004.0,2012.0,323.0,1122.0,1148.0,30.1,92386.0,893,36027160004
36,027,160004,2,"Block Group 2, Census Tract 1600.04, Dutchess County, New York",143,456,599,79,10,0,20,0,34,16,456,599,74,84,100,156,26,143,1997.0,2001.0,2011.0,802.0,978.0,1393.0,25.5,98472.0,1612,36027160004
36,027,160005,1,"Block Group 1, Census Tract 1600.05, Dutchess County, New York",200,213,413,132,18,8,8,10,24,8,213,413,0,34,69,59,43,200,2001.0,2009.0,2012.0,747.0,1198.0,1690.0,33.5,66250.0,1007,36027160005
36,027,160005,2,"Block Group 2, Census Tract 1600.05, Dutchess County, New York",328,188,516,168,67,0,29,13,51,15,188,516,0,68,33,40,32,328,1998.0,2011.0,2012.0,1007.0,1123.0,1239.0,28.7,50333.0,956,36027160005
36,027,160005,3,"Block Group 3, Census Tract 1600.05, Dutchess County, New York",79,230,309,32,17,8,0,0,22,8,230,309,47,15,73,34,53,79,1997.0,2002.0,2011.0,1146.0,1324.0,1438.0,50.0,86607.0,645,36027160005
36,027,170000,2,"Block Group 2, Census Tract 1700, Dutchess County, New York",90,357,447,63,10,11,0,0,6,29,357,447,75,55,92,75,31,90,1995.0,1999.0,2012.0,808.0,848.0,888.0,18.9,104375.0,1065,36027170000
36,027,170000,3,"Block Group 3, Census Tract 1700, Dutchess County, New York",109,294,403,28,41,0,0,0,40,0,294,403,4,132,73,69,16,109,1992.0,1999.0,2013.0,806.0,964.0,1657.0,35.9,67684.0,847,36027170000
36,027,170000,4,"Block Group 4, Census Tract 1700, Dutchess County, New York",81,213,294,36,0,0,10,0,35,0,213,294,44,50,59,24,36,81,1992.0,1997.0,2009.0,717.0,1292.0,1396.0,50.0,79911.0,958,36027170000
36,027,180001,1,"Block Group 1, Census Tract 1800.01, Dutchess County, New York",266,392,658,102,75,0,0,20,69,15,392,658,50,33,98,167,29,266,2001.0,2005.0,2012.0,824.0,926.0,1332.0,50.0,67206.0,1606,36027180001
36,027,180001,2,"Block Group 2, Census Tract 1800.01, Dutchess County, New York",51,350,401,26,0,8,0,17,0,0,350,401,90,34,92,100,34,51,1996.0,1996.0,2010.0,,,,,102574.0,1169,36027180001
36,027,180001,3,"Block Group 3, Census Tract 1800.01, Dutchess County, New York",25,345,370,0,0,0,0,0,25,18,345,370,20,12,90,139,66,25,2004.0,2004.0,2003.0,,,,,123152.0,1004,36027180001
36,027,190101,3,"Block Group 3, Census Tract 1901.01, Dutchess County, New York",64,456,520,24,0,0,0,8,32,17,456,520,112,26,91,181,29,64,2000.0,2001.0,2008.0,520.0,,1667.0,50.0,96316.0,1488,36027190101
36,027,190102,1,"Block Group 1, Census Tract 1901.02, Dutchess County, New York",323,115,438,209,46,5,0,22,41,0,115,438,37,32,11,20,15,323,1986.0,2011.0,2012.0,1000.0,1177.0,1368.0,27.8,57000.0,992,36027190102
36,027,190102,2,"Block Group 2, Census Tract 1901.02, Dutchess County, New York",43,246,289,0,10,0,18,0,15,9,246,289,35,38,44,70,50,43,2001.0,2001.0,2002.0,,,2135.0,35.0,105380.0,879,36027190102
36,027,190203,1,"Block Group 1, Census Tract 1902.03, Dutchess County, New York",170,489,659,124,5,0,0,16,25,4,489,659,77,30,104,223,51,170,2002.0,2004.0,2012.0,817.0,980.0,1118.0,23.8,77417.0,1737,36027190203
36,027,190203,2,"Block Group 2, Census Tract 1902.03, Dutchess County, New York",29,284,313,5,0,5,0,0,19,0,284,313,62,32,55,67,68,29,1999.0,2000.0,2005.0,1125.0,1250.0,1375.0,42.5,74250.0,870,36027190203
36,027,190204,1,"Block Group 1, Census Tract 1902.04, Dutchess County, New York",50,363,413,39,0,0,0,0,11,0,363,413,65,63,34,151,50,50,2001.0,2003.0,2012.0,99.0,1718.0,2202.0,23.2,93011.0,1307,36027190204
36,027,190204,2,"Block Group 2, Census Tract 1902.04, Dutchess County, New York",0,319,319,0,0,0,0,0,0,11,319,319,83,59,98,58,10,0,1992.0,1992.0,,,,,,136250.0,815,36027190204
36,027,190204,3,"Block Group 3, Census Tract 1902.04, Dutchess County, New York",56,473,529,46,0,0,10,0,0,8,473,529,104,51,84,105,121,56,2000.0,2001.0,,,,,,108194.0,1617,36027190204
36,027,190204,4,"Block Group 4, Census Tract 1902.04, Dutchess County, New York",8,336,344,0,0,8,0,0,0,9,336,344,74,40,49,115,49,8,2000.0,2000.0,,,,,,111447.0,1037,36027190204
36,027,190301,1,"Block Group 1, Census Tract 1903.01, Dutchess County, New York",76,382,458,21,8,0,0,5,42,23,382,458,63,39,66,166,25,76,2001.0,2003.0,2008.0,948.0,1054.0,1271.0,21.0,86875.0,1069,36027190301
36,027,190301,2,"Block Group 2, Census Tract 1903.01, Dutchess County, New York",126,287,413,83,0,0,0,0,43,0,287,413,56,10,75,96,50,126,2000.0,2005.0,2011.0,1100.0,1199.0,1355.0,23.7,69764.0,923,36027190301
36,027,080104,2,"Block Group 2, Census Tract 801.04, Dutchess County, New York",37,433,470,12,0,0,0,25,0,10,433,470,77,5,124,93,124,37,2001.0,2000.0,,,,,,85625.0,1486,36027080104
36,027,080104,3,"Block Group 3, Census Tract 801.04, Dutchess County, New York",6,311,317,0,0,6,0,0,0,18,311,317,30,30,88,132,13,6,2001.0,2000.0,,,,,,121477.0,976,36027080104
36,027,080201,1,"Block Group 1, Census Tract 802.01, Dutchess County, New York",15,616,631,0,15,0,0,0,0,35,616,631,74,94,127,201,85,15,2001.0,2001.0,,,,,,113875.0,1792,36027080201
36,027,080201,2,"Block Group 2, Census Tract 802.01, Dutchess County, New York",43,230,273,32,0,0,0,11,0,0,230,273,65,26,102,24,13,43,1992.0,1994.0,2012.0,898.0,1337.0,1587.0,24.5,91125.0,677,36027080201
36,027,080201,3,"Block Group 3, Census Tract 802.01, Dutchess County, New York",0,189,189,0,0,0,0,0,0,16,189,189,38,33,34,35,33,0,1997.0,1997.0,,,,,,115469.0,548,36027080201
36,027,080201,4,"Block Group 4, Census Tract 802.01, Dutchess County, New York",0,503,503,0,0,0,0,0,0,12,503,503,106,68,52,187,78,0,2001.0,2001.0,,,,,,97656.0,1298,36027080201
36,027,080202,1,"Block Group 1, Census Tract 802.02, Dutchess County, New York",6,265,271,6,0,0,0,0,0,0,265,271,57,57,46,89,16,6,1994.0,1995.0,,,,,,109375.0,800,36027080202
36,027,080202,2,"Block Group 2, Census Tract 802.02, Dutchess County, New York",68,287,355,50,18,0,0,0,0,10,287,355,12,5,93,125,42,68,2003.0,2005.0,2013.0,779.0,1104.0,1685.0,26.6,105656.0,965,36027080202
36,027,080202,3,"Block Group 3, Census Tract 802.02, Dutchess County, New York",16,277,293,0,16,0,0,0,0,13,277,293,34,43,60,94,33,16,2000.0,2001.0,,,,,,132708.0,976,36027080202
36,027,090000,2,"Block Group 2, Census Tract 900, Dutchess County, New York",82,553,635,68,5,0,0,0,9,12,553,635,58,58,158,178,89,82,2000.0,2002.0,2012.0,806.0,1058.0,1229.0,48.8,62055.0,1563,36027090000
36,027,100000,3,"Block Group 3, Census Tract 1000, Dutchess County, New York",183,227,410,95,55,10,0,3,20,0,227,410,59,32,32,73,31,183,1997.0,2007.0,2013.0,685.0,769.0,936.0,38.0,46667.0,888,36027100000
36,027,110003,1,"Block Group 1, Census Tract 1100.03, Dutchess County, New York",32,682,714,22,0,0,0,0,10,29,682,714,36,31,139,363,84,32,2004.0,2004.0,2011.0,1125.0,1375.0,1750.0,20.0,114773.0,2138,36027110003
36,027,110003,2,"Block Group 2, Census Tract 1100.03, Dutchess County, New York",120,340,460,30,29,30,0,0,31,8,340,460,54,59,70,98,51,120,1998.0,2001.0,2010.0,2264.0,1979.0,2712.0,50.0,68438.0,1229,36027110003
36,027,110003,3,"Block Group 3, Census Tract 1100.03, Dutchess County, New York",78,260,338,78,0,0,0,0,0,0,260,338,14,51,46,83,66,78,2002.0,2007.0,,847.0,943.0,1625.0,26.6,81250.0,907,36027110003
36,027,190402,1,"Block Group 1, Census Tract 1904.02, Dutchess County, New York",248,455,703,124,85,0,0,0,39,6,455,703,45,44,102,197,61,248,2002.0,2007.0,2013.0,901.0,966.0,1095.0,23.2,62740.0,1592,36027190402
36,111,952500,2,"Block Group 2, Census Tract 9525, Ulster County, New York",96,437,533,54,26,16,0,0,0,6,437,533,110,38,73,150,60,96,2000.0,2002.0,2013.0,775.0,932.0,1103.0,23.7,73350.0,1351,36111952500
36,111,952500,1,"Block Group 1, Census Tract 9525, Ulster County, New York",71,234,305,13,19,0,0,0,39,0,234,305,48,38,47,79,22,71,1997.0,2002.0,2009.0,715.0,738.0,1266.0,45.1,68350.0,615,36111952500
36,027,190301,3,"Block Group 3, Census Tract 1903.01, Dutchess County, New York",582,159,741,385,115,0,11,0,71,0,159,741,59,22,31,47,0,582,1989.0,2012.0,2013.0,1113.0,1235.0,1430.0,23.8,72413.0,1466,36027190301
36,027,190401,1,"Block Group 1, Census Tract 1904.01, Dutchess County, New York",91,273,364,57,24,0,0,3,7,16,273,364,59,38,58,56,46,91,1997.0,2004.0,2013.0,876.0,1639.0,2130.0,18.5,91771.0,902,36027190401
36,027,190401,2,"Block Group 2, Census Tract 1904.01, Dutchess County, New York",90,304,394,75,0,0,0,0,15,8,304,394,74,46,27,97,52,90,2001.0,2004.0,2012.0,1074.0,1250.0,1484.0,50.0,78088.0,1225,36027190401
36,027,190402,2,"Block Group 2, Census Tract 1904.02, Dutchess County, New York",6,606,612,6,0,0,0,0,0,0,606,612,78,70,163,214,81,6,2000.0,2000.0,,,,,,113289.0,1945,36027190402
36,027,200001,1,"Block Group 1, Census Tract 2000.01, Dutchess County, New York",69,268,337,62,0,7,0,0,0,10,268,337,37,80,60,71,10,69,1993.0,1997.0,2012.0,825.0,1045.0,1147.0,12.9,121813.0,894,36027200001
36,027,200001,2,"Block Group 2, Census Tract 2000.01, Dutchess County, New York",57,251,308,48,0,9,0,0,0,0,251,308,55,49,83,55,9,57,1993.0,1995.0,2012.0,1027.0,1102.0,1176.0,19.6,67941.0,797,36027200001
36,027,200001,3,"Block Group 3, Census Tract 2000.01, Dutchess County, New York",169,375,544,77,48,0,0,0,44,17,375,544,109,57,69,113,10,169,1993.0,2002.0,2013.0,753.0,1108.0,1391.0,50.0,77500.0,1489,36027200001
36,027,200002,1,"Block Group 1, Census Tract 2000.02, Dutchess County, New York",353,357,710,182,44,3,2,17,105,0,357,710,95,40,68,121,33,353,1996.0,2006.0,2011.0,882.0,1008.0,1283.0,26.5,79167.0,1515,36027200002
36,027,210101,1,"Block Group 1, Census Tract 2101.01, Dutchess County, New York",263,249,512,233,11,0,0,0,19,51,249,512,46,14,13,109,16,263,2005.0,2011.0,2012.0,855.0,938.0,1105.0,48.9,56250.0,1730,36027210101
36,027,210101,2,"Block Group 2, Census Tract 2101.01, Dutchess County, New York",122,92,214,27,0,23,0,0,72,0,92,214,0,0,0,64,28,122,2007.0,2006.0,2005.0,899.0,868.0,1101.0,35.6,83929.0,564,36027210101
36,027,210101,3,"Block Group 3, Census Tract 2101.01, Dutchess County, New York",110,245,355,68,25,0,0,17,0,25,245,355,40,32,15,61,72,110,2006.0,2010.0,2013.0,1093.0,1346.0,1683.0,43.6,120164.0,1050,36027210101
36,027,210101,4,"Block Group 4, Census Tract 2101.01, Dutchess County, New York",181,322,503,77,54,0,0,12,38,0,322,503,71,22,97,121,11,181,1997.0,2003.0,2013.0,729.0,859.0,1235.0,45.2,118583.0,1510,36027210101
36,027,210101,5,"Block Group 5, Census Tract 2101.01, Dutchess County, New York",169,93,262,58,35,0,0,27,49,0,93,262,0,17,0,47,29,169,2006.0,2009.0,2011.0,246.0,1030.0,1197.0,31.0,27188.0,526,36027210101
36,027,210201,1,"Block Group 1, Census Tract 2102.01, Dutchess County, New York",56,162,218,34,0,0,0,0,22,0,162,218,23,24,25,84,6,56,2001.0,2003.0,2011.0,1338.0,1425.0,1563.0,22.3,90833.0,547,36027210201
36,027,210201,2,"Block Group 2, Census Tract 2102.01, Dutchess County, New York",98,158,256,45,33,0,0,0,20,0,158,256,38,26,17,77,0,98,1999.0,2005.0,2013.0,594.0,725.0,966.0,26.6,78571.0,508,36027210201
36,027,210201,3,"Block Group 3, Census Tract 2102.01, Dutchess County, New York",430,145,575,215,11,0,0,34,170,0,145,575,8,6,13,79,39,430,2006.0,2009.0,2010.0,334.0,655.0,986.0,23.5,39450.0,1264,36027210201
36,027,210201,4,"Block Group 4, Census Tract 2102.01, Dutchess County, New York",94,175,269,82,12,0,0,0,0,9,175,269,27,21,31,67,20,94,2001.0,2008.0,2014.0,436.0,765.0,1031.0,50.0,80521.0,620,36027210201
36,027,210201,5,"Block Group 5, Census Tract 2102.01, Dutchess County, New York",82,205,287,75,7,0,0,0,0,0,205,287,32,46,27,92,8,82,1999.0,2004.0,2013.0,876.0,948.0,1446.0,30.9,112716.0,874,36027210201
36,027,210301,1,"Block Group 1, Census Tract 2103.01, Dutchess County, New York",250,275,525,108,76,0,10,0,56,0,275,525,57,34,76,44,64,250,1996.0,2009.0,2013.0,906.0,980.0,1269.0,31.6,64191.0,1287,36027210301
36,027,210301,2,"Block Group 2, Census Tract 2103.01, Dutchess County, New York",44,224,268,12,16,0,0,0,16,11,224,268,53,9,84,52,15,44,1996.0,1999.0,2013.0,969.0,1094.0,1271.0,18.4,78611.0,744,36027210301
36,027,610000,1,"Block Group 1, Census Tract 6100, Dutchess County, New York",16,0,16,16,0,0,0,0,0,0,0,16,0,0,0,0,0,16,,,,,,,,,2050,36027610000
36,027,640001,1,"Block Group 1, Census Tract 6400.01, Dutchess County, New York",0,0,0,0,0,0,0,0,0,0,0,0,0,0,0,0,0,0,,,,,,,,,1319,36027640001
36,027,640002,1,"Block Group 1, Census Tract 6400.02, Dutchess County, New York",58,0,58,29,0,0,0,0,29,0,0,58,0,0,0,0,0,58,,2010.0,2010.0,779.0,1023.0,1137.0,50.0,24375.0,1467,36027640002
36,071,000300,1,"Block Group 1, Census Tract 3, Orange County, New York",276,151,427,130,47,0,0,19,80,0,151,427,10,9,82,35,15,276,1997.0,2008.0,2012.0,895.0,1093.0,1191.0,42.9,45329.0,1540,36071000300
36,071,000300,2,"Block Group 2, Census Tract 3, Orange County, New York",256,211,467,117,22,26,0,17,74,0,211,467,46,9,51,91,14,256,2000.0,2005.0,2010.0,962.0,1129.0,1365.0,50.0,39844.0,1730,36071000300
36,071,000300,3,"Block Group 3, Census Tract 3, Orange County, New York",137,213,350,22,38,0,0,18,59,0,213,350,22,0,52,139,0,137,2002.0,2004.0,2009.0,929.0,1026.0,1220.0,40.2,50208.0,958,36071000300
36,071,000300,5,"Block Group 5, Census Tract 3, Orange County, New York",320,90,410,155,54,0,0,0,111,0,90,410,31,0,9,50,0,320,2001.0,2010.0,2012.0,819.0,897.0,1127.0,44.8,35185.0,1507,36071000300
36,071,000300,4,"Block Group 4, Census Tract 3, Orange County, New York",230,38,268,101,44,0,0,0,85,0,38,268,25,0,0,13,0,230,1979.0,2011.0,2011.0,746.0,860.0,1128.0,40.5,33423.0,818,36071000300
36,071,011500,4,"Block Group 4, Census Tract 115, Orange County, New York",36,376,412,0,0,12,0,0,24,0,376,412,60,101,79,117,19,36,1993.0,1994.0,2005.0,,,,,80333.0,1054,36071011500
36,071,011500,2,"Block Group 2, Census Tract 115, Orange County, New York",39,462,501,0,8,0,0,8,23,40,462,501,32,135,137,88,30,39,1995.0,1996.0,2005.0,,,,,96985.0,1459,36071011500
36,071,011500,5,"Block Group 5, Census Tract 115, Orange County, New York",143,506,649,60,37,0,2,9,35,8,506,649,49,62,104,200,83,143,2002.0,2004.0,2012.0,650.0,923.0,1573.0,38.8,66875.0,2091,36071011500
36,071,011500,3,"Block Group 3, Census Tract 115, Orange County, New York",18,296,314,18,0,0,0,0,0,7,296,314,34,84,48,72,51,18,1996.0,1998.0,,,,,,78750.0,907,36071011500
36,071,011500,1,"Block Group 1, Census Tract 115, Orange County, New York",0,24,24,0,0,0,0,0,0,0,24,24,0,0,0,24,0,0,,,,,,,,,1482,36071011500
36,071,001100,3,"Block Group 3, Census Tract 11, Orange County, New York",107,359,466,87,13,0,0,0,7,0,359,466,27,34,24,113,161,107,2008.0,2011.0,2013.0,789.0,984.0,1329.0,41.2,50864.0,1610,36071001100
36,071,001100,4,"Block Group 4, Census Tract 11, Orange County, New York",245,141,386,85,22,8,0,31,99,0,141,386,27,20,0,61,33,245,2004.0,2007.0,2008.0,827.0,915.0,992.0,27.3,51422.0,1007,36071001100
36,071,001100,1,"Block Group 1, Census Tract 11, Orange County, New York",178,227,405,67,24,0,0,39,48,0,227,405,74,0,10,125,18,178,2002.0,2005.0,2010.0,911.0,973.0,1091.0,44.2,73542.0,917,36071001100
36,071,001100,2,"Block Group 2, Census Tract 11, Orange County, New York",212,175,387,165,30,0,9,0,8,0,175,387,68,17,9,30,51,212,1993.0,2011.0,2013.0,786.0,1006.0,1176.0,42.2,36571.0,1069,36071001100
36,071,001200,1,"Block Group 1, Census Tract 12, Orange County, New York",304,200,504,163,48,15,0,0,78,5,200,504,61,21,52,44,17,304,1993.0,2008.0,2012.0,920.0,998.0,1168.0,37.8,43704.0,1668,36071001200
36,071,001200,2,"Block Group 2, Census Tract 12, Orange County, New York",180,90,270,128,13,0,0,0,39,9,90,270,12,6,21,42,0,180,2001.0,2011.0,2012.0,696.0,959.0,1156.0,50.0,46000.0,995,36071001200
36,071,001300,1,"Block Group 1, Census Tract 13, Orange County, New York",41,534,575,31,0,0,0,0,10,63,534,575,85,91,73,151,71,41,2001.0,2002.0,2012.0,860.0,1035.0,1142.0,33.8,93875.0,1287,36071001300
36,071,001300,2,"Block Group 2, Census Tract 13, Orange County, New York",73,537,610,40,0,0,0,22,11,0,537,610,72,48,86,205,126,73,2003.0,2004.0,2010.0,974.0,976.0,1565.0,21.5,73786.0,1908,36071001300
36,071,001600,3,"Block Group 3, Census Tract 16, Orange County, New York",348,231,579,130,82,14,14,0,108,0,231,579,19,29,38,113,32,348,2003.0,2008.0,2011.0,1098.0,1250.0,1468.0,25.7,61933.0,1463,36071001600
36,071,001600,1,"Block Group 1, Census Tract 16, Orange County, New York",166,358,524,123,14,17,0,0,12,13,358,524,78,52,32,153,30,166,2001.0,2005.0,2012.0,903.0,954.0,1078.0,49.6,58712.0,1485,36071001600
36,071,001600,2,"Block Group 2, Census Tract 16, Orange County, New York",108,161,269,88,0,0,0,13,7,0,161,269,55,17,34,55,0,108,1993.0,2003.0,2012.0,1333.0,1417.0,1408.0,50.0,76382.0,1021,36071001600
36,071,001600,4,"Block Group 4, Census Tract 16, Orange County, New York",746,669,1415,343,94,41,0,88,180,0,669,1415,43,40,83,414,89,746,2004.0,2007.0,2011.0,798.0,1001.0,1325.0,33.3,51949.0,3011,36071001600
36,071,010200,1,"Block Group 1, Census Tract 102, Orange County, New York",61,367,428,31,0,0,0,0,30,0,367,428,65,47,124,88,43,61,1996.0,1998.0,2010.0,906.0,948.0,991.0,10.0,97386.0,1174,36071010200
36,071,010200,4,"Block Group 4, Census Tract 102, Orange County, New York",113,324,437,69,0,0,0,0,44,11,324,437,84,34,39,118,38,113,2000.0,2004.0,2011.0,,1119.0,1661.0,44.9,63438.0,988,36071010200
36,071,010200,3,"Block Group 3, Census Tract 102, Orange County, New York",100,432,532,27,10,11,0,7,45,33,432,532,18,52,102,138,89,100,2003.0,2004.0,2007.0,1049.0,1199.0,1350.0,24.8,87037.0,1398,36071010200
36,071,010200,2,"Block Group 2, Census Tract 102, Orange County, New York",74,360,434,18,28,0,0,0,28,0,360,434,90,51,8,120,91,74,2003.0,2005.0,2013.0,690.0,1049.0,1194.0,50.0,72727.0,1071,36071010200
36,071,011300,2,"Block Group 2, Census Tract 113, Orange County, New York",272,147,419,187,85,0,0,0,0,0,147,419,0,40,8,99,0,272,2003.0,2012.0,2014.0,841.0,897.0,1140.0,30.2,60673.0,1048,36071011300
36,071,011300,3,"Block Group 3, Census Tract 113, Orange County, New York",322,114,436,122,35,0,0,31,134,0,114,436,0,0,28,65,21,322,2004.0,2008.0,2010.0,926.0,999.0,1234.0,50.0,31250.0,987,36071011300
36,071,011300,4,"Block Group 4, Census Tract 113, Orange County, New York",774,244,1018,319,72,70,22,114,177,27,244,1018,13,12,0,107,85,774,2009.0,2010.0,2010.0,625.0,994.0,1127.0,33.8,37105.0,1962,36071011300
36,071,011300,1,"Block Group 1, Census Tract 113, Orange County, New York",328,251,579,158,82,0,0,0,88,37,251,579,47,54,36,77,0,328,1997.0,2009.0,2012.0,1060.0,1152.0,1243.0,32.0,46619.0,1343,36071011300
36,071,011300,5,"Block Group 5, Census Tract 113, Orange County, New York",106,565,671,29,20,0,0,0,57,14,565,671,53,14,55,259,170,106,2006.0,2007.0,2009.0,1054.0,1205.0,1435.0,19.4,101484.0,2447,36071011300
36,071,012200,3,"Block Group 3, Census Tract 122, Orange County, New York",8,305,313,0,0,0,0,0,8,8,305,313,37,29,113,71,47,8,1998.0,1998.0,,,,,,114554.0,980,36071012200
36,071,012200,1,"Block Group 1, Census Tract 122, Orange County, New York",27,539,566,9,0,0,0,0,18,30,539,566,22,73,160,166,88,27,2001.0,2002.0,2008.0,1241.0,1331.0,1416.0,50.0,105750.0,1828,36071012200
36,071,012200,2,"Block Group 2, Census Tract 122, Orange County, New York",234,150,384,133,55,0,0,8,38,0,150,384,20,15,30,77,8,234,2001.0,2010.0,2013.0,1144.0,1381.0,1619.0,33.3,57845.0,913,36071012200
36,071,012900,1,"Block Group 1, Census Tract 129, Orange County, New York",131,289,420,77,19,4,4,0,27,9,289,420,61,46,83,64,26,131,1995.0,2001.0,2012.0,1020.0,1222.0,1680.0,50.0,108704.0,1215,36071012900
36,071,012900,3,"Block Group 3, Census Tract 129, Orange County, New York",92,210,302,41,28,8,0,9,6,3,210,302,15,40,53,64,35,92,1999.0,2004.0,2013.0,794.0,1078.0,1268.0,20.8,91574.0,721,36071012900
36,071,012900,2,"Block Group 2, Census Tract 129, Orange County, New York",136,220,356,61,16,0,4,17,38,8,220,356,39,56,58,49,10,136,1993.0,2000.0,2011.0,739.0,1053.0,1202.0,28.1,89671.0,879,36071012900
36,071,011000,5,"Block Group 5, Census Tract 110, Orange County, New York",31,176,207,15,8,0,0,0,8,0,176,207,8,9,27,60,72,31,2007.0,2009.0,2013.0,1180.0,1308.0,1404.0,22.2,50179.0,480,36071011000
36,071,011000,2,"Block Group 2, Census Tract 110, Orange County, New York",72,357,429,6,6,0,0,8,52,11,357,429,32,71,82,135,26,72,1999.0,2001.0,2005.0,1019.0,1106.0,1192.0,50.0,87375.0,1130,36071011000
36,071,011000,1,"Block Group 1, Census Tract 110, Orange County, New York",125,259,384,9,46,0,10,0,60,0,259,384,52,41,43,79,44,125,1998.0,2003.0,2009.0,737.0,879.0,1547.0,27.3,44625.0,1362,36071011000
36,071,011000,3,"Block Group 3, Census Tract 110, Orange County, New York",100,246,346,8,6,33,0,0,53,0,246,346,41,15,33,149,8,100,2002.0,2003.0,2003.0,678.0,781.0,1371.0,27.6,60714.0,1043,36071011000
36,071,011000,4,"Block Group 4, Census Tract 110, Orange County, New York",51,320,371,8,29,0,7,7,0,0,320,371,14,87,24,187,8,51,2002.0,2002.0,2016.0,938.0,1560.0,1780.0,50.0,84205.0,934,36071011000
36,071,012700,5,"Block Group 5, Census Tract 127, Orange County, New York",251,130,381,172,45,0,0,7,27,7,130,381,11,0,48,64,0,251,2001.0,2011.0,2013.0,965.0,1135.0,1340.0,41.0,50169.0,938,36071012700
36,071,012700,1,"Block Group 1, Census Tract 127, Orange County, New York",57,178,235,25,0,0,0,0,32,8,178,235,25,13,39,89,4,57,2001.0,2003.0,2009.0,,1319.0,1410.0,23.6,63869.0,714,36071012700
36,071,012700,4,"Block Group 4, Census Tract 127, Orange County, New York",150,188,338,72,63,0,0,15,0,0,188,338,18,26,35,25,84,150,2006.0,2012.0,2014.0,941.0,1006.0,1329.0,35.9,69615.0,839,36071012700
36,111,950500,3,"Block Group 3, Census Tract 9505, Ulster County, New York",147,370,517,124,8,0,0,0,15,0,370,517,96,87,67,72,48,147,1990.0,2001.0,2012.0,762.0,981.0,1232.0,50.0,56411.0,861,36111950500
36,111,950500,1,"Block Group 1, Census Tract 9505, Ulster County, New York",73,531,604,30,24,0,13,0,6,12,531,604,100,77,133,178,31,73,1997.0,1998.0,2013.0,1021.0,1177.0,1674.0,47.1,89318.0,1484,36111950500
36,111,952200,3,"Block Group 3, Census Tract 9522, Ulster County, New York",49,270,319,25,7,0,10,0,7,18,270,319,37,15,74,92,34,49,2001.0,2002.0,2012.0,764.0,796.0,872.0,24.8,101094.0,863,36111952200
36,111,952200,2,"Block Group 2, Census Tract 9522, Ulster County, New York",70,204,274,54,16,0,0,0,0,8,204,274,38,18,39,56,45,70,2001.0,2008.0,2013.0,,961.0,1722.0,31.3,65714.0,566,36111952200
36,111,952200,4,"Block Group 4, Census Tract 9522, Ulster County, New York",73,359,432,37,0,10,0,0,26,19,359,432,74,23,118,105,20,73,1997.0,1999.0,2010.0,1102.0,1261.0,1381.0,31.1,66471.0,1414,36111952200
36,111,952200,1,"Block Group 1, Census Tract 9522, Ulster County, New York",144,219,363,96,0,0,0,28,20,0,219,363,36,38,50,62,33,144,1997.0,2004.0,2011.0,831.0,926.0,984.0,50.0,50156.0,726,36111952200
36,111,954600,1,"Block Group 1, Census Tract 9546, Ulster County, New York",81,620,701,58,0,0,0,0,23,20,620,701,74,85,165,195,81,81,1999.0,2001.0,2012.0,608.0,674.0,1113.0,41.4,62250.0,1649,36111954600
36,111,951300,1,"Block Group 1, Census Tract 9513, Ulster County, New York",191,473,664,131,21,0,0,10,29,0,473,664,66,110,97,115,85,191,1996.0,2003.0,2012.0,531.0,803.0,1002.0,32.3,52891.0,1749,36111951300
36,111,951300,2,"Block Group 2, Census Tract 9513, Ulster County, New York",251,357,608,131,52,0,0,27,41,33,357,608,57,19,74,89,85,251,2003.0,2010.0,2012.0,716.0,899.0,1060.0,40.1,50648.0,1949,36111951300
36,111,951300,3,"Block Group 3, Census Tract 9513, Ulster County, New York",109,161,270,96,0,0,0,0,13,0,161,270,10,9,61,43,38,109,2000.0,2010.0,2012.0,778.0,843.0,983.0,24.7,35948.0,603,36111951300
36,111,951600,2,"Block Group 2, Census Tract 9516, Ulster County, New York",32,493,525,23,9,0,0,0,0,17,493,525,92,77,67,181,59,32,2001.0,2001.0,2013.0,621.0,642.0,856.0,21.1,77122.0,1246,36111951600
36,111,951600,1,"Block Group 1, Census Tract 9516, Ulster County, New York",83,226,309,75,0,0,8,0,0,5,226,309,63,44,34,63,17,83,1992.0,2001.0,,533.0,954.0,1166.0,24.7,78281.0,777,36111951600
36,111,951900,4,"Block Group 4, Census Tract 9519, Ulster County, New York",76,116,192,18,0,11,0,0,47,0,116,192,26,0,35,37,18,76,1999.0,2003.0,2006.0,907.0,938.0,985.0,18.3,62315.0,478,36111951900
36,111,951900,1,"Block Group 1, Census Tract 9519, Ulster County, New York",77,182,259,40,20,15,2,0,0,18,182,259,70,12,0,32,50,77,2003.0,2010.0,2013.0,767.0,828.0,995.0,18.6,70202.0,718,36111951900
36,111,951900,2,"Block Group 2, Census Tract 9519, Ulster County, New York",77,211,288,39,0,0,0,0,38,17,211,288,18,33,46,84,13,77,2001.0,2004.0,2010.0,822.0,1070.0,1444.0,17.3,86250.0,806,36111951900
36,111,951900,3,"Block Group 3, Census Tract 9519, Ulster County, New York",192,51,243,64,17,0,0,12,99,0,51,243,17,12,22,0,0,192,1987.0,2006.0,2008.0,675.0,811.0,880.0,50.0,25000.0,538,36111951900
36,111,952400,2,"Block Group 2, Census Tract 9524, Ulster County, New York",141,362,503,87,22,0,0,8,24,0,362,503,83,41,33,155,50,141,2002.0,2005.0,2012.0,277.0,331.0,769.0,28.9,65938.0,1223,36111952400
36,111,952400,1,"Block Group 1, Census Tract 9524, Ulster County, New York",710,50,760,390,138,24,9,63,86,0,50,760,9,0,0,21,20,710,2008.0,2012.0,2012.0,681.0,832.0,984.0,32.6,29167.0,1469,36111952400
36,111,952900,5,"Block Group 5, Census Tract 9529, Ulster County, New York",230,414,644,153,0,0,0,19,58,64,414,644,61,15,75,161,38,230,2003.0,2007.0,2011.0,852.0,1066.0,1219.0,22.2,63537.0,1584,36111952900
36,111,952900,1,"Block Group 1, Census Tract 9529, Ulster County, New York",135,309,444,77,0,0,0,43,15,55,309,444,0,45,92,55,62,135,2003.0,2006.0,2011.0,831.0,862.0,893.0,21.6,61182.0,990,36111952900
36,111,952900,2,"Block Group 2, Census Tract 9529, Ulster County, New York",21,261,282,21,0,0,0,0,0,12,261,282,37,33,45,91,43,21,2002.0,2003.0,,,,,,62115.0,683,36111952900
36,111,952900,3,"Block Group 3, Census Tract 9529, Ulster County, New York",52,571,623,17,0,19,0,0,16,0,571,623,17,78,214,203,59,52,1999.0,1999.0,2004.0,,,,,76838.0,1350,36111952900
36,111,952900,4,"Block Group 4, Census Tract 9529, Ulster County, New York",61,403,464,29,0,0,0,17,15,0,403,464,136,84,62,60,61,61,1988.0,1992.0,2009.0,901.0,953.0,1026.0,50.0,102738.0,936,36111952900
36,111,953600,3,"Block Group 3, Census Tract 9536, Ulster County, New York",378,503,881,172,177,0,0,0,29,0,503,881,57,65,12,285,84,378,2004.0,2010.0,2015.0,1088.0,1313.0,1763.0,33.7,73882.0,2167,36111953600
36,111,953600,2,"Block Group 2, Census Tract 9536, Ulster County, New York",313,471,784,186,43,45,0,0,39,0,471,784,39,61,123,222,26,313,2001.0,2005.0,2012.0,909.0,994.0,1170.0,50.0,66406.0,2147,36111953600
36,079,010600,2,"Block Group 2, Census Tract 106, Putnam County, New York",43,212,255,10,0,0,0,28,5,9,212,255,33,21,59,81,9,43,1999.0,1998.0,1998.0,843.0,,1788.0,14.3,171033.0,785,36079010600
36,027,130003,1,"Block Group 1, Census Tract 1300.03, Dutchess County, New York",326,50,376,251,12,0,0,0,63,0,50,376,0,8,30,0,12,326,1996.0,2012.0,2012.0,879.0,988.0,1712.0,27.6,51574.0,774,36027130003
36,027,130003,2,"Block Group 2, Census Tract 1300.03, Dutchess County, New York",408,260,668,199,102,0,0,14,93,0,260,668,93,0,59,62,46,408,1996.0,2010.0,2012.0,1006.0,1317.0,1633.0,30.2,54625.0,1384,36027130003
36,027,130003,3,"Block Group 3, Census Tract 1300.03, Dutchess County, New York",53,339,392,11,42,0,0,0,0,71,339,392,14,33,42,124,55,53,2006.0,2009.0,2016.0,805.0,837.0,868.0,50.0,63182.0,1049,36027130003
36,027,130003,4,"Block Group 4, Census Tract 1300.03, Dutchess County, New York",288,623,911,229,59,0,0,0,0,24,623,911,32,101,79,323,64,288,2003.0,2008.0,2013.0,889.0,1194.0,1722.0,44.8,89272.0,2390,36027130003
36,027,130004,1,"Block Group 1, Census Tract 1300.04, Dutchess County, New York",30,195,225,24,0,0,0,0,6,0,195,225,33,68,49,20,25,30,1989.0,1992.0,2012.0,728.0,833.0,1089.0,21.3,97292.0,583,36027130004
36,027,130004,2,"Block Group 2, Census Tract 1300.04, Dutchess County, New York",50,335,385,14,14,5,0,0,17,6,335,385,42,46,87,93,61,50,1999.0,2001.0,2011.0,869.0,1281.0,1777.0,50.0,89688.0,1018,36027130004
36,027,130005,1,"Block Group 1, Census Tract 1300.05, Dutchess County, New York",118,461,579,81,23,0,14,0,0,8,461,579,121,38,62,190,42,118,2001.0,2003.0,2013.0,726.0,1018.0,1333.0,50.0,81639.0,1359,36027130005
36,027,130005,2,"Block Group 2, Census Tract 1300.05, Dutchess County, New York",91,370,461,74,17,0,0,0,0,38,370,461,58,71,62,57,84,91,1999.0,2007.0,2013.0,646.0,1059.0,1236.0,50.0,77548.0,1212,36027130005
36,027,140101,1,"Block Group 1, Census Tract 1401.01, Dutchess County, New York",90,145,235,8,40,0,7,8,27,0,145,235,47,17,15,55,11,90,1996.0,2003.0,2012.0,1016.0,1438.0,1719.0,50.0,70509.0,652,36027140101
36,027,140101,2,"Block Group 2, Census Tract 1401.01, Dutchess County, New York",9,224,233,0,9,0,0,0,0,0,224,233,19,8,110,50,37,9,1998.0,1998.0,,,,,,120660.0,815,36027140101
36,027,140101,3,"Block Group 3, Census Tract 1401.01, Dutchess County, New York",14,253,267,14,0,0,0,0,0,4,253,267,0,30,117,33,69,14,1998.0,1999.0,,,,,,82614.0,717,36027140101
36,027,140101,4,"Block Group 4, Census Tract 1401.01, Dutchess County, New York",0,0,0,0,0,0,0,0,0,0,0,0,0,0,0,0,0,0,,,,,,,,,2468,36027140101
36,027,140101,5,"Block Group 5, Census Tract 1401.01, Dutchess County, New York",228,237,465,192,8,0,0,28,0,27,237,465,103,37,32,15,23,228,1984.0,2010.0,2012.0,924.0,1066.0,1158.0,28.6,54583.0,1286,36027140101
36,027,140200,1,"Block Group 1, Census Tract 1402, Dutchess County, New York",59,390,449,0,13,13,0,0,33,13,390,449,29,71,85,139,53,59,2001.0,2002.0,2005.0,788.0,844.0,1029.0,44.4,110583.0,1151,36027140200
36,027,140200,3,"Block Group 3, Census Tract 1402, Dutchess County, New York",373,448,821,183,48,0,0,13,129,18,448,821,26,16,118,256,14,373,2003.0,2006.0,2011.0,825.0,978.0,1176.0,24.5,77153.0,2021,36027140200
36,027,140200,5,"Block Group 5, Census Tract 1402, Dutchess County, New York",223,239,462,30,21,17,28,0,127,33,239,462,39,74,39,54,0,223,1992.0,2002.0,2005.0,828.0,867.0,918.0,38.4,56897.0,1219,36027140200
36,027,140400,1,"Block Group 1, Census Tract 1404, Dutchess County, New York",20,454,474,20,0,0,0,0,0,0,454,474,113,66,156,89,30,20,1993.0,1994.0,,,,,,101071.0,1377,36027140400
36,027,210301,3,"Block Group 3, Census Tract 2103.01, Dutchess County, New York",74,417,491,20,0,0,0,0,54,0,417,491,26,8,61,267,55,74,2004.0,2005.0,2007.0,923.0,977.0,1340.0,38.9,51625.0,1014,36027210301
36,027,210301,4,"Block Group 4, Census Tract 2103.01, Dutchess County, New York",61,288,349,30,0,0,0,0,31,0,288,349,52,41,110,59,26,61,1995.0,1997.0,,,,,,88281.0,1218,36027210301
36,027,220201,1,"Block Group 1, Census Tract 2202.01, Dutchess County, New York",238,56,294,102,61,0,0,11,64,0,56,294,0,0,0,56,0,238,,2011.0,2012.0,629.0,797.0,1075.0,27.8,38000.0,688,36027220201
36,071,012700,3,"Block Group 3, Census Tract 127, Orange County, New York",91,193,284,55,0,0,0,36,0,10,193,284,38,0,38,56,51,91,2004.0,2005.0,2011.0,963.0,1338.0,1688.0,15.2,62292.0,590,36071012700
36,071,012700,2,"Block Group 2, Census Tract 127, Orange County, New York",104,321,425,49,14,0,0,30,11,7,321,425,34,55,28,173,24,104,2003.0,2004.0,2011.0,910.0,975.0,1095.0,24.0,61052.0,1060,36071012700
36,071,014400,3,"Block Group 3, Census Tract 144, Orange County, New York",37,206,243,13,0,0,0,0,24,9,206,243,36,27,52,78,4,37,1998.0,2001.0,2008.0,837.0,874.0,1125.0,22.4,77188.0,686,36071014400
36,071,014400,1,"Block Group 1, Census Tract 144, Orange County, New York",147,243,390,31,58,0,0,24,34,19,243,390,36,34,24,96,34,147,2003.0,2006.0,2013.0,865.0,1119.0,1633.0,36.2,83000.0,942,36071014400
36,071,014400,2,"Block Group 2, Census Tract 144, Orange County, New York",9,498,507,0,9,0,0,0,0,9,498,507,86,95,79,205,24,9,1999.0,1999.0,1998.0,1116.0,1233.0,,19.1,107891.0,1470,36071014400
36,071,014400,4,"Block Group 4, Census Tract 144, Orange County, New York",105,406,511,62,0,13,0,0,30,6,406,511,37,63,67,189,44,105,2002.0,2003.0,2011.0,940.0,1362.0,1493.0,26.3,86625.0,1469,36071014400
36,071,014301,4,"Block Group 4, Census Tract 143.01, Orange County, New York",226,459,685,116,86,0,0,7,17,8,459,685,6,72,95,241,37,226,2002.0,2006.0,2014.0,1136.0,1341.0,1675.0,33.6,51993.0,1624,36071014301
36,111,952500,3,"Block Group 3, Census Tract 9525, Ulster County, New York",122,395,517,68,16,0,16,0,22,6,395,517,50,95,91,100,53,122,1996.0,2001.0,2012.0,1031.0,1300.0,1622.0,18.5,66653.0,1293,36111952500
36,111,952800,1,"Block Group 1, Census Tract 9528, Ulster County, New York",116,358,474,74,0,19,0,0,23,11,358,474,91,86,78,47,45,116,1990.0,1995.0,2011.0,744.0,784.0,845.0,39.3,88333.0,1181,36111952800
36,111,952800,3,"Block Group 3, Census Tract 9528, Ulster County, New York",100,178,278,37,46,0,0,0,17,0,178,278,67,31,52,13,15,100,1987.0,1998.0,2014.0,1016.0,1145.0,1579.0,50.0,69167.0,667,36111952800
36,111,952800,2,"Block Group 2, Census Tract 9528, Ulster County, New York",56,525,581,30,26,0,0,0,0,72,525,581,94,85,48,132,94,56,2003.0,2005.0,2015.0,783.0,927.0,981.0,50.0,58819.0,1381,36111952800
36,111,953300,1,"Block Group 1, Census Tract 9533, Ulster County, New York",118,324,442,39,34,0,8,5,32,3,324,442,64,16,93,101,47,118,1999.0,2003.0,2012.0,1180.0,1592.0,2014.0,42.8,101364.0,1361,36111953300
36,111,953300,2,"Block Group 2, Census Tract 9533, Ulster County, New York",45,383,428,17,9,12,0,7,0,16,383,428,67,86,49,108,57,45,1998.0,1999.0,2011.0,804.0,1292.0,2542.0,50.0,101944.0,1190,36111953300
36,111,953300,3,"Block Group 3, Census Tract 9533, Ulster County, New York",80,649,729,45,27,0,0,8,0,15,649,729,99,71,213,171,80,80,1997.0,1999.0,2014.0,729.0,841.0,1056.0,21.4,101607.0,2010,36111953300
36,111,954800,3,"Block Group 3, Census Tract 9548, Ulster County, New York",119,312,431,32,0,0,15,0,72,0,312,431,62,0,50,150,50,119,2003.0,2004.0,2006.0,693.0,1293.0,1397.0,33.2,41653.0,1140,36111954800
36,111,954800,2,"Block Group 2, Census Tract 9548, Ulster County, New York",474,221,695,207,96,0,0,15,156,0,221,695,10,58,46,48,59,474,1999.0,2010.0,2012.0,378.0,619.0,824.0,28.5,41082.0,2097,36111954800
36,111,954800,1,"Block Group 1, Census Tract 9548, Ulster County, New York",455,355,810,339,48,0,0,14,54,0,355,810,36,76,55,138,50,455,2001.0,2010.0,2012.0,657.0,716.0,883.0,38.5,46318.0,1939,36111954800
36,079,010200,5,"Block Group 5, Census Tract 102, Putnam County, New York",42,426,468,0,42,0,0,0,0,0,426,468,31,0,189,172,34,42,2000.0,2001.0,,,,,,127031.0,1549,36079010200
36,027,100000,2,"Block Group 2, Census Tract 1000, Dutchess County, New York",108,257,365,30,31,7,0,15,25,28,257,365,39,31,67,66,26,108,1999.0,2003.0,2011.0,639.0,848.0,899.0,25.3,64637.0,833,36027100000
36,027,100000,1,"Block Group 1, Census Tract 1000, Dutchess County, New York",175,257,432,122,13,0,0,5,35,13,257,432,19,57,67,101,0,175,1998.0,2005.0,2012.0,939.0,1043.0,1146.0,26.9,65313.0,1276,36027100000
36,027,220300,2,"Block Group 2, Census Tract 2203, Dutchess County, New York",394,82,476,225,65,0,17,9,78,10,82,476,14,13,9,26,10,394,2002.0,2012.0,2012.0,578.0,1071.0,1183.0,29.1,39318.0,1209,36027220300
36,027,220300,1,"Block Group 1, Census Tract 2203, Dutchess County, New York",465,191,656,196,141,0,0,19,109,8,191,656,21,9,47,81,25,465,2002.0,2011.0,2013.0,357.0,586.0,878.0,37.2,31346.0,1585,36027220300
36,021,000100,2,"Block Group 2, Census Tract 1, Columbia County, New York",110,313,423,80,21,0,4,0,5,0,313,423,94,23,89,64,43,110,1994.0,2000.0,2013.0,681.0,765.0,789.0,50.0,52250.0,839,36021000100
36,021,000100,1,"Block Group 1, Census Tract 1, Columbia County, New York",137,445,582,34,38,6,14,7,38,8,445,582,116,56,110,81,74,137,1995.0,1998.0,2011.0,720.0,904.0,1133.0,22.1,58409.0,1528,36021000100
36,021,000200,1,"Block Group 1, Census Tract 2, Columbia County, New York",34,273,307,19,3,0,3,6,3,17,273,307,51,40,49,78,38,34,1999.0,2001.0,2011.0,881.0,1125.0,1594.0,40.6,76250.0,845,36021000200
36,021,000200,2,"Block Group 2, Census Tract 2, Columbia County, New York",66,309,375,36,5,0,9,8,8,20,309,375,29,63,61,101,35,66,2000.0,2002.0,2011.0,548.0,825.0,1163.0,35.0,77083.0,906,36021000200
36,021,000300,1,"Block Group 1, Census Tract 3, Columbia County, New York",97,266,363,44,17,0,0,4,32,13,266,363,58,48,75,45,27,97,1994.0,2000.0,2011.0,520.0,565.0,873.0,35.2,58350.0,723,36021000300
36,021,000300,2,"Block Group 2, Census Tract 3, Columbia County, New York",34,207,241,0,0,0,6,0,28,0,207,241,57,40,19,62,29,34,1993.0,1999.0,2004.0,,,,,102770.0,467,36021000300
36,021,000300,3,"Block Group 3, Census Tract 3, Columbia County, New York",129,203,332,81,31,0,9,0,8,0,203,332,13,34,61,71,24,129,1999.0,2006.0,2013.0,544.0,926.0,1035.0,26.1,71625.0,916,36021000300
36,021,000300,4,"Block Group 4, Census Tract 3, Columbia County, New York",57,357,414,31,14,0,0,12,0,42,357,414,48,46,108,91,22,57,1998.0,1999.0,2013.0,622.0,645.0,896.0,48.8,87604.0,968,36021000300
36,021,000300,5,"Block Group 5, Census Tract 3, Columbia County, New York",118,267,385,37,29,0,0,16,36,10,267,385,42,22,122,40,31,118,1996.0,1999.0,2011.0,759.0,826.0,1027.0,36.1,68906.0,904,36021000300
36,021,000401,1,"Block Group 1, Census Tract 4.01, Columbia County, New York",192,926,1118,115,42,0,11,0,24,36,926,1118,138,99,279,270,104,192,1998.0,2001.0,2013.0,673.0,860.0,1328.0,27.5,84500.0,2498,36021000401
36,021,000402,1,"Block Group 1, Census Tract 4.02, Columbia County, New York",83,582,665,12,34,0,0,37,0,5,582,665,84,106,100,229,58,83,2000.0,2000.0,2012.0,449.0,633.0,772.0,10.0,72310.0,1866,36021000402
36,021,000402,2,"Block Group 2, Census Tract 4.02, Columbia County, New York",256,825,1081,75,103,3,0,28,47,13,825,1081,120,127,193,247,125,256,1999.0,2002.0,2013.0,514.0,646.0,748.0,24.1,68750.0,3025,36021000402
36,021,000402,3,"Block Group 3, Census Tract 4.02, Columbia County, New York",97,300,397,60,0,0,0,0,37,21,300,397,44,0,43,126,66,97,2005.0,2007.0,2011.0,583.0,712.0,736.0,50.0,91940.0,1004,36021000402
36,083,052503,1,"Block Group 1, Census Tract 525.03, Rensselaer County, New York",153,371,524,75,49,0,0,4,25,3,371,524,62,60,77,123,46,153,1998.0,2004.0,2013.0,543.0,693.0,793.0,31.4,71667.0,1350,36083052503
36,027,010000,1,"Block Group 1, Census Tract 100, Dutchess County, New York",249,282,531,133,84,0,0,0,32,9,282,531,29,45,87,112,0,249,1998.0,2007.0,2013.0,1013.0,1092.0,1171.0,31.7,54656.0,1486,36027010000
36,027,010000,2,"Block Group 2, Census Tract 100, Dutchess County, New York",95,298,393,36,41,0,9,9,0,0,298,393,61,31,64,101,41,95,1999.0,2002.0,2014.0,538.0,825.0,1016.0,25.4,39125.0,715,36027010000
36,027,010000,3,"Block Group 3, Census Tract 100, Dutchess County, New York",109,376,485,64,36,9,0,0,0,0,376,485,9,76,103,167,21,109,2000.0,2003.0,2014.0,722.0,775.0,837.0,33.2,80353.0,1466,36027010000
36,027,120000,2,"Block Group 2, Census Tract 1200, Dutchess County, New York",143,316,459,48,0,0,17,21,57,0,316,459,45,78,101,75,17,143,1993.0,1997.0,2006.0,,615.0,941.0,19.7,44963.0,1092,36027120000
36,027,120000,1,"Block Group 1, Census Tract 1200, Dutchess County, New York",136,453,589,112,24,0,0,0,0,22,453,589,124,66,64,119,58,136,1996.0,2003.0,2013.0,958.0,1130.0,1336.0,50.0,59432.0,1412,36027120000
36,027,140200,4,"Block Group 4, Census Tract 1402, Dutchess County, New York",217,383,600,69,17,0,0,0,131,0,383,600,24,53,0,269,37,217,2004.0,2006.0,2008.0,1101.0,1228.0,1469.0,29.6,67692.0,1304,36027140200
36,027,140200,2,"Block Group 2, Census Tract 1402, Dutchess County, New York",32,412,444,18,0,0,0,0,14,0,412,444,78,16,109,121,88,32,2000.0,2001.0,,,,,,61978.0,1135,36027140200
36,027,300000,4,"Block Group 4, Census Tract 3000, Dutchess County, New York",183,201,384,132,25,0,0,0,26,0,201,384,97,22,30,30,22,183,1982.0,2008.0,2012.0,988.0,1081.0,1165.0,29.6,62262.0,1026,36027300000
36,027,040001,4,"Block Group 4, Census Tract 400.01, Dutchess County, New York",340,157,497,215,34,0,0,0,91,10,157,497,35,41,0,52,19,340,2000.0,2011.0,2012.0,507.0,646.0,951.0,20.5,44159.0,827,36027040001
36,027,040001,2,"Block Group 2, Census Tract 400.01, Dutchess County, New York",132,594,726,77,0,0,27,0,28,0,594,726,18,43,134,368,31,132,2003.0,2004.0,2011.0,894.0,939.0,981.0,50.0,83333.0,2277,36027040001
36,105,950800,1,"Block Group 1, Census Tract 9508, Sullivan County, New York",0,9,9,0,0,0,0,0,0,0,9,9,0,0,0,9,0,0,,,,,,,,,365,36105950800
36,105,950800,3,"Block Group 3, Census Tract 9508, Sullivan County, New York",64,362,426,26,0,0,7,0,31,15,362,426,87,78,76,48,58,64,1992.0,1995.0,2008.0,677.0,758.0,823.0,34.5,43824.0,939,36105950800
36,105,950800,4,"Block Group 4, Census Tract 9508, Sullivan County, New York",56,260,316,42,0,0,0,0,14,0,260,316,51,16,85,96,12,56,1997.0,2001.0,2012.0,475.0,525.0,585.0,14.3,45625.0,1025,36105950800
36,105,950800,2,"Block Group 2, Census Tract 9508, Sullivan County, New York",181,617,798,60,71,0,0,0,50,38,617,798,57,23,141,207,151,181,2004.0,2007.0,2013.0,614.0,641.0,697.0,50.0,44474.0,2196,36105950800
36,105,952000,2,"Block Group 2, Census Tract 9520, Sullivan County, New York",124,172,296,14,18,0,18,0,74,30,172,296,29,13,76,7,17,124,1996.0,2001.0,2006.0,519.0,538.0,543.0,13.1,81667.0,660,36105952000
36,105,952000,1,"Block Group 1, Census Tract 9520, Sullivan County, New York",13,313,326,0,13,0,0,0,0,0,313,326,53,56,102,89,13,13,1995.0,1995.0,,,,,,65333.0,723,36105952000
36,105,952200,2,"Block Group 2, Census Tract 9522, Sullivan County, New York",54,231,285,33,4,0,0,3,14,0,231,285,26,54,43,67,41,54,1998.0,2002.0,2012.0,706.0,722.0,739.0,26.5,54271.0,712,36105952200
36,105,952200,1,"Block Group 1, Census Tract 9522, Sullivan County, New York",92,243,335,30,21,4,0,0,37,0,243,335,27,55,47,74,40,92,1998.0,2003.0,2011.0,540.0,694.0,798.0,19.4,61648.0,809,36105952200
36,105,952300,1,"Block Group 1, Census Tract 9523, Sullivan County, New York",155,457,612,89,33,0,3,6,24,10,457,612,44,82,71,171,79,155,2002.0,2005.0,2013.0,496.0,556.0,715.0,26.4,45682.0,1302,36105952300
36,105,951200,4,"Block Group 4, Census Tract 9512, Sullivan County, New York",59,297,356,0,34,0,0,0,25,0,297,356,0,36,69,141,51,59,2003.0,2004.0,2016.0,,,2283.0,21.1,86172.0,1150,36105951200
36,105,951200,5,"Block Group 5, Census Tract 9512, Sullivan County, New York",167,107,274,82,10,0,7,25,43,0,107,274,16,2,11,67,11,167,2004.0,2007.0,2011.0,523.0,727.0,988.0,34.3,41806.0,844,36105951200
36,105,951200,7,"Block Group 7, Census Tract 9512, Sullivan County, New York",32,355,387,32,0,0,0,0,0,25,355,387,14,96,39,80,101,32,2004.0,2006.0,,,,,,88789.0,1252,36105951200
36,105,951200,1,"Block Group 1, Census Tract 9512, Sullivan County, New York",69,343,412,25,15,0,0,0,29,27,343,412,51,0,127,116,22,69,1999.0,2002.0,2011.0,910.0,1034.0,1142.0,28.7,99091.0,1532,36105951200
36,105,951200,3,"Block Group 3, Census Tract 9512, Sullivan County, New York",123,263,386,93,17,0,0,0,13,7,263,386,37,26,36,117,40,123,2003.0,2007.0,2013.0,614.0,759.0,853.0,25.5,64423.0,993,36105951200
36,105,951200,2,"Block Group 2, Census Tract 9512, Sullivan County, New York",97,260,357,16,37,0,0,0,44,0,260,357,32,0,89,78,61,97,2001.0,2005.0,2011.0,722.0,904.0,1086.0,28.8,60587.0,1033,36105951200
36,105,951200,6,"Block Group 6, Census Tract 9512, Sullivan County, New York",29,233,262,0,0,0,19,0,10,0,233,262,0,0,24,204,5,29,2005.0,2004.0,2002.0,,,,,62786.0,785,36105951200
36,105,951700,1,"Block Group 1, Census Tract 9517, Sullivan County, New York",146,211,357,49,14,0,0,28,55,7,211,357,55,18,47,84,0,146,1997.0,2002.0,2008.0,715.0,746.0,1099.0,15.2,68750.0,1064,36105951700
36,083,052502,3,"Block Group 3, Census Tract 525.02, Rensselaer County, New York",43,370,413,32,11,0,0,0,0,0,370,413,38,82,84,115,51,43,1998.0,2000.0,2013.0,532.0,615.0,751.0,50.0,54063.0,1088,36083052502
36,083,052502,2,"Block Group 2, Census Tract 525.02, Rensselaer County, New York",36,477,513,0,36,0,0,0,0,72,477,513,39,65,81,168,52,36,2003.0,2004.0,,,,,,100509.0,1311,36083052502
36,083,052502,1,"Block Group 1, Census Tract 525.02, Rensselaer County, New York",97,729,826,75,0,0,0,0,22,14,729,826,105,135,213,174,88,97,1996.0,1998.0,2012.0,638.0,948.0,1053.0,19.5,100536.0,2345,36083052502
36,083,052603,1,"Block Group 1, Census Tract 526.03, Rensselaer County, New York",76,429,505,42,0,0,9,0,25,16,429,505,10,71,211,46,75,76,1996.0,1998.0,2010.0,474.0,543.0,724.0,31.2,68603.0,1238,36083052603
36,083,052603,2,"Block Group 2, Census Tract 526.03, Rensselaer County, New York",129,651,780,37,37,0,0,7,48,12,651,780,94,80,99,277,89,129,2002.0,2003.0,2011.0,468.0,789.0,1333.0,22.0,69130.0,1668,36083052603
36,027,040001,3,"Block Group 3, Census Tract 400.01, Dutchess County, New York",31,201,232,0,0,0,31,0,0,0,201,232,55,35,27,68,16,31,1994.0,1989.0,,,,,,54219.0,618,36027040001
36,027,040001,1,"Block Group 1, Census Tract 400.01, Dutchess County, New York",114,206,320,104,0,0,10,0,0,0,206,320,0,23,12,110,61,114,2006.0,2010.0,2012.0,759.0,791.0,1270.0,24.1,54375.0,921,36027040001
36,027,060100,1,"Block Group 1, Census Tract 601, Dutchess County, New York",65,572,637,48,17,0,0,0,0,16,572,637,37,19,141,244,115,65,2004.0,2005.0,2013.0,1335.0,1419.0,1522.0,20.7,135540.0,2065,36027060100
36,027,140300,4,"Block Group 4, Census Tract 1403, Dutchess County, New York",101,253,354,86,0,0,0,15,0,0,253,354,0,0,131,72,50,101,2000.0,2004.0,2012.0,813.0,848.0,883.0,50.0,78196.0,1107,36027140300
36,027,140300,3,"Block Group 3, Census Tract 1403, Dutchess County, New York",191,102,293,72,69,0,0,0,50,15,102,293,28,0,11,48,0,191,2003.0,2011.0,2013.0,798.0,1081.0,1165.0,32.1,49884.0,554,36027140300
36,027,140300,6,"Block Group 6, Census Tract 1403, Dutchess County, New York",722,73,795,465,175,0,0,20,62,0,73,795,13,0,17,43,0,722,2002.0,2013.0,2013.0,1035.0,1143.0,1253.0,29.1,50125.0,1562,36027140300
36,027,140300,1,"Block Group 1, Census Tract 1403, Dutchess County, New York",58,53,111,40,18,0,0,0,0,0,53,111,0,0,0,53,0,58,,2010.0,2014.0,,952.0,1618.0,17.9,112171.0,528,36027140300
36,027,140300,2,"Block Group 2, Census Tract 1403, Dutchess County, New York",43,315,358,0,0,0,0,0,43,0,315,358,66,12,17,203,17,43,2003.0,2003.0,,,,,,60286.0,976,36027140300
36,027,140300,5,"Block Group 5, Census Tract 1403, Dutchess County, New York",522,128,650,354,17,0,15,58,78,0,128,650,0,37,35,14,42,522,1998.0,2011.0,2012.0,682.0,1056.0,1335.0,30.4,43411.0,1137,36027140300
36,027,170000,1,"Block Group 1, Census Tract 1700, Dutchess County, New York",36,315,351,0,4,0,0,0,32,17,315,351,31,31,77,96,63,36,2002.0,2003.0,,,,,,76094.0,914,36027170000
36,027,070101,2,"Block Group 2, Census Tract 701.01, Dutchess County, New York",87,443,530,36,0,17,0,14,20,13,443,530,53,30,150,149,48,87,1999.0,2000.0,2006.0,847.0,895.0,990.0,18.7,97756.0,1418,36027070101
36,027,070101,3,"Block Group 3, Census Tract 701.01, Dutchess County, New York",139,533,672,58,19,0,0,9,53,0,533,672,127,117,121,150,18,139,1992.0,1997.0,2011.0,598.0,848.0,1194.0,16.9,79821.0,1798,36027070101
36,027,220100,1,"Block Group 1, Census Tract 2201, Dutchess County, New York",161,189,350,98,18,15,0,17,13,46,189,350,41,18,17,48,19,161,2004.0,2010.0,2012.0,489.0,735.0,910.0,38.4,29191.0,705,36027220100
36,027,220100,2,"Block Group 2, Census Tract 2201, Dutchess County, New York",823,0,823,474,167,0,0,0,182,0,0,823,0,0,0,0,0,823,,2012.0,2012.0,673.0,855.0,1097.0,50.0,23472.0,1485,36027220100
36,027,220100,3,"Block Group 3, Census Tract 2201, Dutchess County, New York",257,84,341,161,57,0,0,39,0,0,84,341,15,36,19,14,0,257,1988.0,2011.0,2013.0,608.0,831.0,928.0,24.8,48197.0,756,36027220100
36,027,220100,4,"Block Group 4, Census Tract 2201, Dutchess County, New York",717,0,717,306,26,0,17,142,226,0,0,717,0,0,0,0,0,717,,2009.0,2009.0,361.0,644.0,901.0,50.0,16313.0,1427,36027220100
36,027,220700,2,"Block Group 2, Census Tract 2207, Dutchess County, New York",200,115,315,95,31,0,0,0,74,0,115,315,47,18,21,15,14,200,1986.0,2008.0,2011.0,836.0,1041.0,1201.0,34.2,49150.0,924,36027220700
36,027,220700,3,"Block Group 3, Census Tract 2207, Dutchess County, New York",380,22,402,194,40,5,7,15,119,0,22,402,6,16,0,0,0,380,1983.0,2011.0,2011.0,542.0,700.0,875.0,24.5,28681.0,884,36027220700
36,027,220700,1,"Block Group 1, Census Tract 2207, Dutchess County, New York",108,236,344,96,8,0,0,0,4,29,236,344,7,25,22,111,42,108,2006.0,2010.0,2013.0,1125.0,1500.0,1800.0,36.0,58125.0,618,36027220700
36,027,030000,1,"Block Group 1, Census Tract 300, Dutchess County, New York",70,401,471,25,7,0,0,15,23,6,401,471,50,68,94,130,53,70,1999.0,2001.0,2009.0,1069.0,1138.0,1206.0,38.5,74732.0,1382,36027030000
36,027,050102,2,"Block Group 2, Census Tract 501.02, Dutchess County, New York",94,756,850,33,61,0,0,0,0,0,756,850,172,108,156,183,137,94,1996.0,1999.0,2016.0,1504.0,1685.0,1865.0,50.0,85333.0,2837,36027050102
36,027,050102,1,"Block Group 1, Census Tract 501.02, Dutchess County, New York",10,424,434,10,0,0,0,0,0,0,424,434,76,31,118,110,89,10,1999.0,1999.0,,,,,,114956.0,1266,36027050102
36,027,070102,1,"Block Group 1, Census Tract 701.02, Dutchess County, New York",33,111,144,24,0,0,0,0,9,0,111,144,0,21,48,37,5,33,1997.0,2001.0,2012.0,99.0,947.0,976.0,25.3,55726.0,399,36027070102
36,027,140400,2,"Block Group 2, Census Tract 1404, Dutchess County, New York",57,660,717,35,0,0,0,7,15,38,660,717,76,59,130,282,75,57,2002.0,2003.0,2011.0,843.0,886.0,1203.0,50.0,127361.0,2440,36027140400
36,027,140400,3,"Block Group 3, Census Tract 1404, Dutchess County, New York",6,599,605,0,0,0,0,0,6,34,599,605,117,26,181,161,80,6,1999.0,1999.0,2007.0,1223.0,1653.0,1826.0,23.5,126354.0,1798,36027140400
36,105,951700,2,"Block Group 2, Census Tract 9517, Sullivan County, New York",31,414,445,7,0,7,0,0,17,16,414,445,20,7,34,262,75,31,2006.0,2006.0,2005.0,1114.0,1228.0,1473.0,22.5,102865.0,1195,36105951700
36,105,951700,4,"Block Group 4, Census Tract 9517, Sullivan County, New York",67,381,448,19,0,2,0,0,46,4,381,448,59,90,80,109,39,67,1995.0,1999.0,2007.0,493.0,950.0,1188.0,19.6,76000.0,1103,36105951700
36,105,950100,4,"Block Group 4, Census Tract 9501, Sullivan County, New York",36,240,276,12,10,0,0,0,14,20,240,276,0,33,49,131,7,36,2003.0,2004.0,2012.0,,,,,92159.0,874,36105950100
36,105,950100,2,"Block Group 2, Census Tract 9501, Sullivan County, New York",75,222,297,51,8,7,0,0,9,0,222,297,16,60,39,71,36,75,1999.0,2003.0,2012.0,648.0,1011.0,1131.0,50.0,72188.0,783,36105950100
36,105,950100,1,"Block Group 1, Census Tract 9501, Sullivan County, New York",114,270,384,57,0,0,0,8,49,0,270,384,32,26,59,126,27,114,2001.0,2004.0,2010.0,627.0,655.0,681.0,50.0,69100.0,1099,36105950100
36,105,950100,3,"Block Group 3, Census Tract 9501, Sullivan County, New York",55,209,264,39,5,0,0,0,11,0,209,264,31,54,36,67,21,55,1995.0,2001.0,2012.0,655.0,797.0,975.0,23.4,69688.0,700,36105950100
36,105,951800,4,"Block Group 4, Census Tract 9518, Sullivan County, New York",412,107,519,267,35,0,0,15,95,0,107,519,0,0,85,22,0,412,1996.0,2011.0,2012.0,672.0,751.0,903.0,38.4,31205.0,1350,36105951800
36,105,951800,1,"Block Group 1, Census Tract 9518, Sullivan County, New York",20,113,133,20,0,0,0,0,0,0,113,133,13,65,26,9,0,20,1987.0,1988.0,,,,,,59063.0,607,36105951800
36,105,951800,6,"Block Group 6, Census Tract 9518, Sullivan County, New York",117,70,187,62,0,0,0,0,55,0,70,187,32,0,0,0,38,117,2010.0,2010.0,2010.0,847.0,894.0,1117.0,18.3,34081.0,569,36105951800
36,105,951800,2,"Block Group 2, Census Tract 9518, Sullivan County, New York",501,54,555,250,40,0,0,79,132,0,54,555,32,12,0,10,0,501,1979.0,2010.0,2011.0,195.0,644.0,782.0,35.0,15771.0,1088,36105951800
36,105,950200,2,"Block Group 2, Census Tract 9502, Sullivan County, New York",61,223,284,11,14,0,0,36,0,40,223,284,25,45,9,83,21,61,2004.0,2003.0,1998.0,803.0,846.0,888.0,19.2,54857.0,758,36105950200
36,105,950400,3,"Block Group 3, Census Tract 9504, Sullivan County, New York",101,199,300,52,37,0,0,4,8,0,199,300,43,31,39,66,20,101,1997.0,2004.0,2014.0,440.0,700.0,743.0,27.5,43750.0,746,36105950400
36,105,951000,1,"Block Group 1, Census Tract 9510, Sullivan County, New York",440,350,790,196,68,0,5,18,153,0,350,790,50,17,89,146,48,440,2001.0,2007.0,2011.0,605.0,696.0,966.0,35.8,40417.0,1487,36105951000
36,105,951100,2,"Block Group 2, Census Tract 9511, Sullivan County, New York",40,43,83,27,13,0,0,0,0,0,43,83,6,5,27,5,0,40,1994.0,2007.0,2014.0,629.0,715.0,1308.0,17.9,49602.0,1758,36105951100
36,105,951300,2,"Block Group 2, Census Tract 9513, Sullivan County, New York",55,296,351,36,0,0,0,0,19,0,296,351,62,4,86,113,31,55,2000.0,2002.0,2011.0,544.0,593.0,804.0,48.9,45208.0,811,36105951300
36,105,951600,1,"Block Group 1, Census Tract 9516, Sullivan County, New York",49,269,318,25,0,0,0,24,0,29,269,318,65,37,0,88,50,49,2004.0,2004.0,,,,,,36250.0,641,36105951600
36,105,951600,3,"Block Group 3, Census Tract 9516, Sullivan County, New York",276,44,320,126,31,17,12,58,32,0,44,320,0,9,9,26,0,276,2002.0,2009.0,2011.0,344.0,444.0,626.0,28.4,30000.0,959,36105951600
36,105,951700,3,"Block Group 3, Census Tract 9517, Sullivan County, New York",69,253,322,53,0,0,0,7,9,40,253,322,34,54,83,42,0,69,1995.0,1998.0,2012.0,846.0,850.0,1023.0,20.4,81250.0,696,36105951700
36,105,951800,3,"Block Group 3, Census Tract 9518, Sullivan County, New York",113,197,310,15,0,0,0,0,98,0,197,310,61,17,0,119,0,113,2002.0,2004.0,2006.0,716.0,839.0,1054.0,46.1,34151.0,619,36105951800
36,105,951800,5,"Block Group 5, Census Tract 9518, Sullivan County, New York",354,169,523,288,53,0,0,0,13,0,169,523,61,67,16,0,25,354,1984.0,2012.0,2014.0,579.0,786.0,931.0,24.9,76823.0,1631,36105951800
36,105,951900,2,"Block Group 2, Census Tract 9519, Sullivan County, New York",288,300,588,165,22,0,0,0,101,19,300,588,12,47,63,115,44,288,2002.0,2008.0,2011.0,560.0,623.0,840.0,23.8,46250.0,1307,36105951900
36,105,952000,3,"Block Group 3, Census Tract 9520, Sullivan County, New York",102,232,334,10,0,20,0,10,62,20,232,334,0,66,68,78,0,102,1997.0,2000.0,2003.0,170.0,,1115.0,18.5,69000.0,804,36105952000
36,105,952400,2,"Block Group 2, Census Tract 9524, Sullivan County, New York",139,355,494,73,0,0,5,0,61,6,355,494,44,49,63,164,29,139,2001.0,2004.0,2010.0,584.0,734.0,1165.0,50.0,47500.0,1087,36105952400
36,105,952500,2,"Block Group 2, Census Tract 9525, Sullivan County, New York",45,574,619,31,0,0,0,6,8,11,574,619,59,39,140,250,75,45,2002.0,2003.0,2011.0,716.0,741.0,1104.0,13.1,71122.0,1772,36105952500
36,111,950900,1,"Block Group 1, Census Tract 9509, Ulster County, New York",73,200,273,32,3,6,16,4,12,5,200,273,20,35,59,71,10,73,1998.0,1999.0,2009.0,785.0,1014.0,1132.0,26.3,66250.0,672,36111950900
36,111,953400,4,"Block Group 4, Census Tract 9534, Ulster County, New York",366,128,494,244,54,0,0,12,56,0,128,494,11,0,6,86,25,366,2005.0,2011.0,2012.0,930.0,1058.0,1349.0,34.8,39100.0,1055,36111953400
36,111,954400,5,"Block Group 5, Census Tract 9544, Ulster County, New York",30,425,455,21,9,0,0,0,0,0,425,455,85,59,128,130,23,30,1995.0,1997.0,2013.0,675.0,850.0,1225.0,32.5,80644.0,1246,36111954400
36,111,955400,1,"Block Group 1, Census Tract 9554, Ulster County, New York",233,369,602,94,18,22,0,51,48,9,369,602,61,32,76,99,92,233,2002.0,2004.0,2009.0,803.0,854.0,909.0,35.5,73023.0,1617,36111955400
36,111,955400,2,"Block Group 2, Census Tract 9554, Ulster County, New York",36,299,335,6,14,0,0,16,0,0,299,335,41,43,53,127,35,36,2001.0,2001.0,2012.0,628.0,1313.0,1679.0,50.0,110547.0,1986,36111955400
36,111,955400,3,"Block Group 3, Census Tract 9554, Ulster County, New York",94,270,364,14,0,35,0,0,45,0,270,364,34,10,54,100,72,94,2004.0,2003.0,2003.0,430.0,657.0,673.0,50.0,67381.0,828,36111955400
36,039,080900,2,"Block Group 2, Census Tract 809, Greene County, New York",47,257,304,5,0,8,0,9,25,6,257,304,81,31,39,94,6,47,1994.0,1997.0,2003.0,,,,,83167.0,938,36039080900
36,039,080900,1,"Block Group 1, Census Tract 809, Greene County, New York",29,331,360,0,0,0,0,0,29,9,331,360,96,38,43,134,11,29,1997.0,2000.0,,,,,,38214.0,987,36039080900
36,039,080900,4,"Block Group 4, Census Tract 809, Greene County, New York",107,196,303,51,21,7,0,14,14,0,196,303,55,46,14,51,30,107,1989.0,2002.0,2012.0,669.0,812.0,943.0,33.2,51685.0,795,36039080900
36,039,080900,3,"Block Group 3, Census Tract 809, Greene County, New York",132,354,486,46,16,0,0,3,67,17,354,486,75,49,54,130,29,132,2000.0,2003.0,2009.0,215.0,708.0,773.0,24.8,51136.0,1231,36039080900
36,039,081000,3,"Block Group 3, Census Tract 810, Greene County, New York",204,349,553,94,33,0,0,0,77,12,349,553,105,73,59,72,28,204,1990.0,2003.0,2011.0,264.0,333.0,556.0,50.0,34096.0,1342,36039081000
36,039,081000,2,"Block Group 2, Census Tract 810, Greene County, New York",245,83,328,167,0,19,0,0,59,0,83,328,0,18,22,22,21,245,2001.0,2011.0,2011.0,609.0,631.0,678.0,32.3,60278.0,970,36039081000
36,039,081000,1,"Block Group 1, Census Tract 810, Greene County, New York",184,227,411,136,33,0,0,0,15,0,227,411,145,30,0,35,17,184,1979.0,2006.0,2013.0,662.0,718.0,780.0,50.0,31281.0,1156,36039081000
36,039,081000,4,"Block Group 4, Census Tract 810, Greene County, New York",353,119,472,198,14,16,0,18,107,0,119,472,70,12,22,8,7,353,1979.0,2009.0,2011.0,519.0,567.0,599.0,50.0,19444.0,946,36039081000
36,039,080600,2,"Block Group 2, Census Tract 806, Greene County, New York",107,444,551,32,5,6,8,9,47,18,444,551,18,62,69,184,93,107,2004.0,2004.0,2006.0,535.0,639.0,741.0,39.4,77171.0,1409,36039080600
36,039,080600,1,"Block Group 1, Census Tract 806, Greene County, New York",77,473,550,6,10,0,0,17,44,30,473,550,75,19,189,93,67,77,1998.0,1999.0,2005.0,605.0,,1319.0,16.7,79659.0,1946,36039080600
36,027,410000,1,"Block Group 1, Census Tract 4100, Dutchess County, New York",13,51,64,7,0,0,0,0,6,0,51,64,12,11,16,12,0,13,1992.0,1996.0,2012.0,,,,,102917.0,2224,36027410000
36,027,140500,1,"Block Group 1, Census Tract 1405, Dutchess County, New York",393,309,702,87,22,0,0,63,221,28,309,702,36,50,80,75,40,393,1999.0,2004.0,2006.0,365.0,825.0,997.0,35.8,30750.0,1257,36027140500
36,071,013100,1,"Block Group 1, Census Tract 131, Orange County, New York",31,172,203,14,0,0,0,17,0,0,172,203,19,33,60,60,0,31,1996.0,1996.0,1999.0,693.0,919.0,1285.0,28.4,109250.0,534,36071013100
36,071,013100,3,"Block Group 3, Census Tract 131, Orange County, New York",19,414,433,19,0,0,0,0,0,19,414,433,60,79,44,129,83,19,2002.0,2003.0,2011.0,1227.0,1655.0,1827.0,50.0,117396.0,1211,36071013100
36,071,013100,4,"Block Group 4, Census Tract 131, Orange County, New York",22,181,203,8,14,0,0,0,0,0,181,203,60,8,0,60,53,22,2004.0,2006.0,,,,,,182639.0,529,36071013100
36,071,013100,5,"Block Group 5, Census Tract 131, Orange County, New York",307,243,550,158,9,9,0,12,119,0,243,550,24,66,75,66,12,307,1994.0,2005.0,2010.0,1117.0,1274.0,1411.0,49.4,63036.0,1319,36071013100
36,071,013100,2,"Block Group 2, Census Tract 131, Orange County, New York",54,356,410,23,0,0,0,0,31,0,356,410,0,27,34,171,124,54,2007.0,2007.0,2009.0,1025.0,1100.0,1175.0,10.0,161333.0,1259,36071013100
36,071,013600,1,"Block Group 1, Census Tract 136, Orange County, New York",776,14,790,566,149,0,0,0,61,0,14,790,0,0,0,5,9,776,2011.0,2014.0,2013.0,2691.0,3092.0,3362.0,40.9,100234.0,6541,36071013600
36,071,013900,1,"Block Group 1, Census Tract 139, Orange County, New York",14,173,187,14,0,0,0,0,0,0,173,187,0,52,12,94,15,14,2002.0,2003.0,,,,,,110598.0,661,36071013900
36,071,013900,2,"Block Group 2, Census Tract 139, Orange County, New York",23,173,196,23,0,0,0,0,0,0,173,196,48,25,48,39,13,23,1993.0,1995.0,,,,,,101848.0,520,36071013900
36,071,013900,3,"Block Group 3, Census Tract 139, Orange County, New York",98,271,369,47,31,0,13,0,7,0,271,369,42,32,66,95,36,98,1999.0,2003.0,2013.0,1240.0,1524.0,1762.0,35.7,114063.0,1273,36071013900
36,071,013900,4,"Block Group 4, Census Tract 139, Orange County, New York",0,596,596,0,0,0,0,0,0,28,596,596,104,91,133,132,108,0,1998.0,1998.0,,,,,,122700.0,2069,36071013900
36,071,014800,1,"Block Group 1, Census Tract 148, Orange County, New York",80,481,561,48,0,0,0,0,32,0,481,561,20,160,73,215,13,80,1998.0,2001.0,,,,,,84355.0,1518,36071014800
36,071,014800,3,"Block Group 3, Census Tract 148, Orange County, New York",103,227,330,64,11,0,28,0,0,0,227,330,0,96,95,36,0,103,1992.0,1994.0,2012.0,992.0,1078.0,1164.0,18.7,77900.0,925,36071014800
36,071,014800,6,"Block Group 6, Census Tract 148, Orange County, New York",222,323,545,120,59,14,0,9,20,3,323,545,21,15,102,104,78,222,2002.0,2009.0,2013.0,731.0,1027.0,1518.0,29.1,51298.0,1106,36071014800
36,071,014800,2,"Block Group 2, Census Tract 148, Orange County, New York",13,175,188,8,0,0,0,0,5,0,175,188,18,65,40,47,5,13,1991.0,1993.0,2013.0,,,,27.5,72500.0,429,36071014800
36,071,014800,5,"Block Group 5, Census Tract 148, Orange County, New York",134,380,514,40,26,0,0,15,53,0,380,514,44,98,119,100,19,134,1994.0,1999.0,2010.0,912.0,997.0,1443.0,26.3,129063.0,1525,36071014800
36,071,014800,4,"Block Group 4, Census Tract 148, Orange County, New York",71,363,434,38,0,0,0,0,33,0,363,434,9,30,71,86,167,71,2008.0,2009.0,2009.0,630.0,821.0,880.0,,67292.0,977,36071014800
36,071,012300,2,"Block Group 2, Census Tract 123, Orange County, New York",0,523,523,0,0,0,0,0,0,0,523,523,115,63,91,139,115,0,1999.0,1999.0,,,,,,98490.0,1850,36071012300
36,071,012300,1,"Block Group 1, Census Tract 123, Orange County, New York",18,279,297,10,0,0,0,0,8,11,279,297,15,34,54,122,43,18,2003.0,2004.0,,,,,,109464.0,1162,36071012300
36,071,012300,3,"Block Group 3, Census Tract 123, Orange County, New York",33,339,372,23,0,0,0,0,10,23,339,372,8,29,132,103,44,33,2000.0,2002.0,1999.0,1556.0,1704.0,1852.0,19.3,111154.0,1254,36071012300
36,071,012300,4,"Block Group 4, Census Tract 123, Orange County, New York",44,343,387,23,0,8,0,0,13,0,343,387,33,29,76,174,31,44,2002.0,2003.0,2010.0,,,,,114625.0,1190,36071012300
36,071,013300,4,"Block Group 4, Census Tract 133, Orange County, New York",122,505,627,56,25,0,0,18,23,0,505,627,96,105,96,119,89,122,1995.0,2000.0,2012.0,825.0,965.0,1718.0,28.3,124219.0,1934,36071013300
36,071,013300,3,"Block Group 3, Census Tract 133, Orange County, New York",72,373,445,17,0,55,0,0,0,0,373,445,6,60,207,100,0,72,1996.0,1995.0,,,,,,103239.0,1348,36071013300
36,071,013300,1,"Block Group 1, Census Tract 133, Orange County, New York",52,519,571,7,0,0,0,0,45,0,519,571,147,84,136,137,15,52,1992.0,1994.0,,,,,,133902.0,1705,36071013300
36,071,013300,2,"Block Group 2, Census Tract 133, Orange County, New York",137,695,832,32,36,0,0,18,51,0,695,832,55,106,107,398,29,137,2002.0,2003.0,2010.0,754.0,798.0,1124.0,25.4,73750.0,2235,36071013300
36,071,014302,2,"Block Group 2, Census Tract 143.02, Orange County, New York",31,671,702,0,31,0,0,0,0,79,671,702,58,98,104,221,111,31,2003.0,2004.0,,,,,,104704.0,2380,36071014302
36,071,014302,1,"Block Group 1, Census Tract 143.02, Orange County, New York",60,519,579,60,0,0,0,0,0,0,519,579,25,54,214,138,88,60,1998.0,2000.0,,,,,,103375.0,2095,36071014302
36,071,014302,3,"Block Group 3, Census Tract 143.02, Orange County, New York",0,136,136,0,0,0,0,0,0,16,136,136,23,16,24,42,15,0,2001.0,2001.0,,,,,,119792.0,594,36071014302
36,071,014302,4,"Block Group 4, Census Tract 143.02, Orange County, New York",0,470,470,0,0,0,0,0,0,12,470,470,38,62,146,112,100,0,1999.0,1999.0,,,,,,124897.0,1840,36071014302
36,071,014700,3,"Block Group 3, Census Tract 147, Orange County, New York",0,0,0,0,0,0,0,0,0,0,0,0,0,0,0,0,0,0,,,,,,,,,49,36071014700
36,071,014700,2,"Block Group 2, Census Tract 147, Orange County, New York",76,517,593,17,15,0,0,0,44,41,517,593,36,93,127,157,63,76,2000.0,2002.0,2009.0,1173.0,1608.0,1804.0,,119375.0,2046,36071014700
36,071,014700,1,"Block Group 1, Census Tract 147, Orange County, New York",28,612,640,28,0,0,0,0,0,19,612,640,47,23,277,175,71,28,1999.0,1999.0,2012.0,1554.0,1702.0,1851.0,20.6,99758.0,1934,36071014700
36,071,014900,3,"Block Group 3, Census Tract 149, Orange County, New York",190,580,770,108,28,14,0,0,40,56,580,770,34,56,134,196,104,190,2003.0,2006.0,2012.0,1021.0,1337.0,2093.0,42.5,98558.0,1866,36071014900
36,071,014900,1,"Block Group 1, Census Tract 149, Orange County, New York",79,365,444,15,27,0,0,6,31,22,365,444,50,34,112,90,57,79,1999.0,2002.0,2011.0,1565.0,1710.0,1855.0,50.0,105326.0,1074,36071014900
36,071,014900,2,"Block Group 2, Census Tract 149, Orange County, New York",43,195,238,8,15,0,0,2,18,7,195,238,27,27,45,51,38,43,2000.0,2003.0,2011.0,1281.0,1375.0,1469.0,48.0,129881.0,612,36071014900
36,071,013800,1,"Block Group 1, Census Tract 138, Orange County, New York",172,211,383,108,12,12,0,0,40,0,211,383,68,26,60,32,25,172,1992.0,2004.0,2012.0,945.0,1058.0,1214.0,30.9,58319.0,745,36071013800
36,071,013800,2,"Block Group 2, Census Tract 138, Orange County, New York",101,225,326,12,63,0,0,7,19,16,225,326,62,38,29,76,4,101,1994.0,2003.0,2016.0,1119.0,1287.0,1434.0,17.3,103594.0,967,36071013800
36,071,013800,3,"Block Group 3, Census Tract 138, Orange County, New York",149,320,469,100,35,0,0,0,14,4,320,469,43,12,130,99,32,149,1998.0,2004.0,2013.0,849.0,1183.0,1781.0,27.2,81736.0,1217,36071013800
36,071,000200,1,"Block Group 1, Census Tract 2, Orange County, New York",223,315,538,125,56,0,0,0,42,6,315,538,22,53,33,167,34,223,2003.0,2008.0,2013.0,,988.0,1137.0,43.4,47292.0,1582,36071000200
36,071,000200,2,"Block Group 2, Census Tract 2, Orange County, New York",91,294,385,53,0,0,0,11,27,38,294,385,26,53,51,117,9,91,2001.0,2004.0,2011.0,995.0,1131.0,1298.0,50.0,58750.0,1280,36071000200
36,071,002100,1,"Block Group 1, Census Tract 21, Orange County, New York",88,290,378,69,0,0,0,11,8,30,290,378,12,28,35,176,9,88,2004.0,2006.0,2012.0,908.0,966.0,1073.0,19.6,100806.0,1136,36071002100
36,071,002100,3,"Block Group 3, Census Tract 21, Orange County, New York",167,314,481,97,0,0,0,0,70,0,314,481,144,10,36,22,102,167,1991.0,2005.0,2011.0,696.0,806.0,895.0,32.3,44830.0,1106,36071002100
36,071,002100,2,"Block Group 2, Census Tract 21, Orange County, New York",235,272,507,105,50,26,0,0,54,0,272,507,81,60,41,76,14,235,1989.0,2004.0,2012.0,522.0,819.0,874.0,29.3,40972.0,982,36071002100
36,071,002200,1,"Block Group 1, Census Tract 22, Orange County, New York",291,163,454,142,43,0,40,12,54,0,163,454,44,0,17,102,0,291,2002.0,2007.0,2011.0,718.0,776.0,856.0,29.9,47121.0,1487,36071002200
36,071,002200,2,"Block Group 2, Census Tract 22, Orange County, New York",182,228,410,108,0,0,0,9,65,25,228,410,11,35,26,118,13,182,2004.0,2007.0,2011.0,725.0,1022.0,1144.0,43.0,48235.0,1269,36071002200
36,071,002200,3,"Block Group 3, Census Tract 22, Orange County, New York",404,97,501,236,43,0,20,39,66,0,97,501,22,7,24,35,9,404,1998.0,2011.0,2012.0,380.0,643.0,773.0,43.8,22966.0,831,36071002200
36,071,002300,1,"Block Group 1, Census Tract 23, Orange County, New York",90,314,404,74,0,0,0,3,13,10,314,404,52,75,72,88,17,90,1994.0,2000.0,2012.0,728.0,1014.0,1132.0,34.2,49286.0,1045,36071002300
36,071,002300,2,"Block Group 2, Census Tract 23, Orange County, New York",136,147,283,80,5,0,0,0,51,0,147,283,36,21,7,27,56,136,2004.0,2010.0,2011.0,894.0,955.0,1293.0,38.0,53073.0,814,36071002300
36,071,010500,4,"Block Group 4, Census Tract 105, Orange County, New York",243,610,853,163,80,0,0,0,0,23,610,853,68,40,47,423,9,243,2004.0,2006.0,2014.0,1179.0,1569.0,1928.0,16.8,105139.0,2539,36071010500
36,071,010500,1,"Block Group 1, Census Tract 105, Orange County, New York",171,417,588,100,71,0,0,0,0,0,417,588,24,64,156,129,44,171,1998.0,2004.0,2014.0,1130.0,1326.0,1638.0,28.8,101176.0,1662,36071010500
36,071,010500,3,"Block Group 3, Census Tract 105, Orange County, New York",0,194,194,0,0,0,0,0,0,10,194,194,58,13,18,48,47,0,2002.0,2002.0,,,,,,87917.0,473,36071010500
36,071,010500,2,"Block Group 2, Census Tract 105, Orange County, New York",86,300,386,0,50,0,0,27,9,21,300,386,99,0,41,74,65,86,2001.0,2003.0,2016.0,,,,,101563.0,938,36071010500
36,071,010500,5,"Block Group 5, Census Tract 105, Orange County, New York",47,426,473,0,47,0,0,0,0,0,426,473,141,72,106,70,37,47,1990.0,1992.0,,,,,,74688.0,1331,36071010500
36,001,014402,2,"Block Group 2, Census Tract 144.02, Albany County, New York",204,466,670,103,37,0,18,9,37,23,466,670,126,34,71,147,65,204,2000.0,2004.0,2012.0,,731.0,827.0,35.0,61280.0,1569,36001014402
36,001,014402,1,"Block Group 1, Census Tract 144.02, Albany County, New York",325,363,688,140,89,10,0,18,68,0,363,688,28,21,90,146,78,325,2003.0,2008.0,2012.0,694.0,778.0,840.0,35.0,48910.0,1697,36001014402
36,039,080201,1,"Block Group 1, Census Tract 802.01, Greene County, New York",106,243,349,34,0,6,14,0,52,9,243,349,52,52,65,47,18,106,1993.0,1998.0,2006.0,689.0,848.0,1177.0,42.8,38714.0,925,36039080201
36,039,080201,2,"Block Group 2, Census Tract 802.01, Greene County, New York",73,496,569,56,6,0,0,0,11,17,496,569,93,22,134,130,100,73,2000.0,2003.0,2012.0,629.0,832.0,957.0,41.8,54803.0,1430,36039080201
36,039,080201,3,"Block Group 3, Census Tract 802.01, Greene County, New York",59,370,429,41,7,0,0,0,11,28,370,429,33,98,69,121,21,59,1998.0,2001.0,2012.0,778.0,932.0,980.0,43.2,49542.0,1258,36039080201
36,039,080202,1,"Block Group 1, Census Tract 802.02, Greene County, New York",61,378,439,4,33,0,0,5,19,14,378,439,106,29,88,123,18,61,1996.0,1999.0,2016.0,540.0,574.0,658.0,45.0,54750.0,1312,36039080202
36,039,080202,2,"Block Group 2, Census Tract 802.02, Greene County, New York",107,380,487,55,26,4,0,5,17,6,380,487,64,30,73,153,54,107,2002.0,2004.0,2013.0,713.0,741.0,898.0,34.8,52109.0,1369,36039080202
36,039,080401,1,"Block Group 1, Census Tract 804.01, Greene County, New York",47,195,242,47,0,0,0,0,0,0,195,242,18,69,11,76,21,47,2000.0,2003.0,2011.0,531.0,816.0,858.0,42.5,48860.0,436,36039080401
36,039,080401,2,"Block Group 2, Census Tract 804.01, Greene County, New York",131,384,515,127,4,0,0,0,0,0,384,515,49,72,48,164,51,131,2001.0,2005.0,2012.0,627.0,771.0,834.0,27.8,54570.0,1445,36039080401
36,039,080401,3,"Block Group 3, Census Tract 804.01, Greene County, New York",168,273,441,72,58,0,0,16,22,0,273,441,21,32,88,119,13,168,1999.0,2005.0,2013.0,99.0,691.0,758.0,33.3,41528.0,769,36039080401
36,071,010500,6,"Block Group 6, Census Tract 105, Orange County, New York",57,384,441,57,0,0,0,0,0,0,384,441,97,34,38,98,117,57,2002.0,2005.0,,,,,,62676.0,1254,36071010500
36,111,954400,2,"Block Group 2, Census Tract 9544, Ulster County, New York",126,473,599,48,0,0,0,64,14,0,473,599,45,102,83,220,23,126,2000.0,2000.0,2000.0,660.0,1004.0,1127.0,31.6,74391.0,1481,36111954400
36,111,954400,4,"Block Group 4, Census Tract 9544, Ulster County, New York",14,539,553,0,14,0,0,0,0,0,539,553,33,27,185,230,64,14,2001.0,2001.0,,,,,,78940.0,1788,36111954400
36,111,954400,1,"Block Group 1, Census Tract 9544, Ulster County, New York",116,379,495,65,0,17,0,19,15,14,379,495,54,31,120,160,0,116,1999.0,2000.0,2011.0,618.0,827.0,879.0,10.0,120640.0,3280,36111954400
36,111,954400,3,"Block Group 3, Census Tract 9544, Ulster County, New York",59,543,602,45,14,0,0,0,0,0,543,602,16,150,91,207,79,59,2001.0,2002.0,2014.0,831.0,861.0,892.0,51.0,88846.0,1869,36111954400
36,111,952600,4,"Block Group 4, Census Tract 9526, Ulster County, New York",56,151,207,0,0,0,30,0,26,0,151,207,36,51,0,42,22,56,1988.0,1988.0,2005.0,,956.0,1075.0,32.2,54556.0,545,36111952600
36,111,952600,5,"Block Group 5, Census Tract 9526, Ulster County, New York",67,485,552,15,42,0,0,0,10,58,485,552,53,52,155,97,70,67,1999.0,2001.0,2016.0,744.0,2101.0,2301.0,50.0,74861.0,1670,36111952600
36,111,952600,1,"Block Group 1, Census Tract 9526, Ulster County, New York",271,207,478,128,32,0,12,0,99,0,207,478,72,49,28,58,0,271,1986.0,2005.0,2011.0,878.0,1087.0,1191.0,24.6,63070.0,1125,36111952600
36,111,952600,2,"Block Group 2, Census Tract 9526, Ulster County, New York",124,288,412,69,0,0,0,27,28,0,288,412,29,50,81,56,72,124,1998.0,2002.0,2011.0,614.0,642.0,721.0,13.9,88894.0,1442,36111952600
36,111,952600,3,"Block Group 3, Census Tract 9526, Ulster County, New York",88,297,385,31,27,0,0,0,30,0,297,385,58,41,77,19,102,88,1996.0,2003.0,2012.0,785.0,848.0,1067.0,45.7,72589.0,845,36111952600
36,111,950500,2,"Block Group 2, Census Tract 9505, Ulster County, New York",100,242,342,23,41,0,0,8,28,72,242,342,23,23,55,57,12,100,2004.0,2007.0,2013.0,847.0,968.0,1167.0,33.8,51875.0,874,36111950500
36,079,010500,3,"Block Group 3, Census Tract 105, Putnam County, New York",133,658,791,76,18,0,0,18,21,21,658,791,122,93,162,202,58,133,1997.0,2000.0,2012.0,834.0,1306.0,1712.0,34.0,119107.0,2404,36079010500
36,079,010500,1,"Block Group 1, Census Tract 105, Putnam County, New York",82,311,393,16,38,0,0,0,28,0,311,393,50,109,66,49,37,82,1990.0,1996.0,2014.0,866.0,1030.0,1140.0,35.9,83750.0,1218,36079010500
36,079,010500,2,"Block Group 2, Census Tract 105, Putnam County, New York",92,494,586,8,0,0,0,8,76,26,494,586,150,97,26,137,58,92,1990.0,2001.0,2005.0,1156.0,1325.0,1413.0,11.1,135417.0,1583,36079010500
36,079,010400,1,"Block Group 1, Census Tract 104, Putnam County, New York",73,348,421,36,11,0,26,0,0,15,348,421,48,141,23,72,49,73,1989.0,1990.0,2011.0,774.0,797.0,1233.0,19.7,90795.0,1162,36079010400
36,079,010400,2,"Block Group 2, Census Tract 104, Putnam County, New York",68,201,269,61,7,0,0,0,0,16,201,269,28,36,43,64,14,68,1998.0,2004.0,2013.0,917.0,1585.0,1793.0,19.1,114726.0,881,36079010400
36,079,010400,3,"Block Group 3, Census Tract 104, Putnam County, New York",38,483,521,9,0,0,0,9,20,36,483,521,40,37,84,219,67,38,2004.0,2004.0,2005.0,1014.0,1269.0,1452.0,25.7,103594.0,1468,36079010400
36,071,011701,2,"Block Group 2, Census Tract 117.01, Orange County, New York",123,572,695,7,64,12,11,0,29,0,572,695,60,104,57,234,117,123,2003.0,2004.0,2016.0,99.0,681.0,1332.0,24.0,74271.0,2069,36071011701
36,071,011701,3,"Block Group 3, Census Tract 117.01, Orange County, New York",5,273,278,0,0,5,0,0,0,0,273,278,45,54,22,98,54,5,2002.0,2001.0,,,,,,86719.0,997,36071011701
36,071,011702,1,"Block Group 1, Census Tract 117.02, Orange County, New York",88,513,601,65,0,0,0,0,23,0,513,601,71,67,143,167,65,88,1998.0,2001.0,2012.0,1250.0,1333.0,1417.0,27.3,89980.0,1976,36071011702
36,071,011702,2,"Block Group 2, Census Tract 117.02, Orange County, New York",117,382,499,18,0,0,0,34,65,0,382,499,48,41,37,219,37,117,2003.0,2003.0,2004.0,647.0,929.0,995.0,32.7,87719.0,1539,36071011702
36,071,011702,3,"Block Group 3, Census Tract 117.02, Orange County, New York",45,336,381,31,7,0,0,0,7,15,336,381,31,21,70,134,65,45,2003.0,2005.0,2013.0,1034.0,1125.0,1216.0,42.1,80673.0,998,36071011702
36,071,011801,1,"Block Group 1, Census Tract 118.01, Orange County, New York",250,453,703,163,49,0,0,0,38,20,453,703,32,99,93,174,35,250,2000.0,2006.0,2013.0,1096.0,1321.0,1583.0,50.0,64406.0,2061,36071011801
36,071,011801,2,"Block Group 2, Census Tract 118.01, Orange County, New York",25,176,201,0,0,0,0,0,25,12,176,201,61,8,22,38,35,25,1999.0,2002.0,,722.0,745.0,859.0,41.1,97031.0,637,36071011801
36,071,011801,3,"Block Group 3, Census Tract 118.01, Orange County, New York",210,496,706,123,44,0,9,0,34,33,496,706,76,118,116,91,62,210,1995.0,2003.0,2013.0,,1328.0,1625.0,44.8,70938.0,1923,36071011801
36,071,011802,1,"Block Group 1, Census Tract 118.02, Orange County, New York",62,344,406,10,0,19,0,5,28,12,344,406,33,22,92,170,15,62,2001.0,2002.0,2003.0,666.0,696.0,790.0,27.4,109167.0,1341,36071011802
36,071,011802,2,"Block Group 2, Census Tract 118.02, Orange County, New York",85,345,430,31,16,0,0,0,38,4,345,430,30,61,86,125,39,85,1999.0,2002.0,2011.0,730.0,1125.0,2024.0,18.7,125132.0,1326,36071011802
36,071,012601,1,"Block Group 1, Census Tract 126.01, Orange County, New York",166,440,606,128,31,0,7,0,0,8,440,606,72,36,137,133,54,166,1998.0,2004.0,2013.0,844.0,888.0,994.0,24.3,115000.0,2422,36071012601
36,071,012601,2,"Block Group 2, Census Tract 126.01, Orange County, New York",48,694,742,8,11,0,0,17,12,0,694,742,68,55,114,396,61,48,2003.0,2003.0,2006.0,855.0,1938.0,2239.0,50.0,74318.0,1837,36071012601
36,071,012602,1,"Block Group 1, Census Tract 126.02, Orange County, New York",178,413,591,114,42,8,7,0,7,0,413,591,31,15,67,240,60,178,2004.0,2007.0,2013.0,958.0,1123.0,1334.0,42.0,66831.0,1630,36071012602
36,071,012602,2,"Block Group 2, Census Tract 126.02, Orange County, New York",273,112,385,114,44,0,0,40,75,0,112,385,53,24,0,7,28,273,1981.0,2009.0,2011.0,935.0,1051.0,1158.0,41.5,36528.0,786,36071012602
36,071,012602,3,"Block Group 3, Census Tract 126.02, Orange County, New York",281,168,449,259,8,0,0,8,6,0,168,449,8,16,48,80,16,281,2002.0,2011.0,2012.0,696.0,925.0,1345.0,47.6,27176.0,893,36071012602
36,071,013201,1,"Block Group 1, Census Tract 132.01, Orange County, New York",27,210,237,0,0,0,0,0,27,0,210,237,0,26,93,73,18,27,1998.0,2000.0,2007.0,947.0,,2230.0,27.2,127546.0,561,36071013201
36,071,013201,2,"Block Group 2, Census Tract 132.01, Orange County, New York",8,322,330,0,8,0,0,0,0,0,322,330,67,19,85,119,32,8,1999.0,1999.0,,,,,,99138.0,1387,36071013201
36,027,050205,2,"Block Group 2, Census Tract 502.05, Dutchess County, New York",20,306,326,0,11,0,0,9,0,0,306,326,26,173,12,65,30,20,1987.0,1988.0,,,,,,123571.0,912,36027050205
36,027,050205,3,"Block Group 3, Census Tract 502.05, Dutchess County, New York",86,452,538,42,30,0,7,0,7,34,452,538,80,104,174,52,8,86,1992.0,1994.0,2013.0,681.0,1003.0,1127.0,50.0,77683.0,1556,36027050205
36,027,050205,4,"Block Group 4, Census Tract 502.05, Dutchess County, New York",92,212,304,34,13,14,0,0,31,0,212,304,35,41,40,34,62,92,1998.0,2003.0,2010.0,952.0,1531.0,1901.0,40.4,80714.0,846,36027050205
36,027,060100,2,"Block Group 2, Census Tract 601, Dutchess County, New York",926,311,1237,576,276,0,9,0,65,0,311,1237,50,0,50,130,81,926,2004.0,2012.0,2013.0,1269.0,1525.0,1781.0,28.1,74792.0,2690,36027060100
36,027,060201,1,"Block Group 1, Census Tract 602.01, Dutchess County, New York",98,461,559,52,12,0,0,0,34,14,461,559,58,39,105,212,33,98,2001.0,2003.0,2011.0,867.0,967.0,1107.0,27.6,85417.0,1338,36027060201
36,027,060201,2,"Block Group 2, Census Tract 602.01, Dutchess County, New York",167,211,378,26,73,6,5,10,47,6,211,378,45,34,34,66,26,167,1998.0,2005.0,2013.0,1056.0,1148.0,1240.0,39.4,58684.0,851,36027060201
36,027,060201,3,"Block Group 3, Census Tract 602.01, Dutchess County, New York",68,426,494,51,11,0,6,0,0,28,426,494,17,82,50,104,145,68,2006.0,2009.0,2013.0,1114.0,1228.0,1723.0,19.6,80417.0,1262,36027060201
36,027,060202,1,"Block Group 1, Census Tract 602.02, Dutchess County, New York",252,283,535,80,39,28,0,10,95,7,283,535,114,35,37,49,41,252,1988.0,2003.0,2009.0,843.0,1080.0,1225.0,24.4,58028.0,1083,36027060202
36,027,060202,2,"Block Group 2, Census Tract 602.02, Dutchess County, New York",206,410,616,127,42,0,0,37,0,27,410,616,20,9,76,139,139,206,2007.0,2011.0,2013.0,1038.0,1172.0,1324.0,39.6,50789.0,1645,36027060202
36,027,060202,3,"Block Group 3, Census Tract 602.02, Dutchess County, New York",9,307,316,9,0,0,0,0,0,9,307,316,45,51,33,105,64,9,2002.0,2003.0,2004.0,,1360.0,1475.0,50.0,144688.0,900,36027060202
36,027,060202,4,"Block Group 4, Census Tract 602.02, Dutchess County, New York",9,222,231,9,0,0,0,0,0,0,222,231,26,29,40,43,84,9,2004.0,2005.0,,,,,,108250.0,674,36027060202
36,027,060301,1,"Block Group 1, Census Tract 603.01, Dutchess County, New York",2,375,377,2,0,0,0,0,0,0,375,377,50,36,143,126,20,2,1997.0,1997.0,,,,,,108194.0,1326,36027060301
36,027,060301,2,"Block Group 2, Census Tract 603.01, Dutchess County, New York",22,318,340,0,4,0,0,0,18,0,318,340,76,71,82,59,30,22,1991.0,1993.0,2006.0,,,,,100893.0,831,36027060301
36,027,060301,3,"Block Group 3, Census Tract 603.01, Dutchess County, New York",87,283,370,37,0,7,0,12,31,0,283,370,73,18,51,121,20,87,2000.0,2002.0,2008.0,1048.0,1167.0,1375.0,24.7,103311.0,1150,36027060301
36,027,060301,4,"Block Group 4, Census Tract 603.01, Dutchess County, New York",84,299,383,48,14,0,0,0,22,17,299,383,49,9,61,100,63,84,2003.0,2006.0,2012.0,1292.0,1366.0,1440.0,30.8,83229.0,1001,36027060301
36,027,060302,1,"Block Group 1, Census Tract 603.02, Dutchess County, New York",193,899,1092,131,28,0,0,20,14,20,899,1092,36,67,51,430,295,193,2007.0,2008.0,2012.0,1152.0,2010.0,2422.0,25.8,103077.0,2602,36027060302
36,027,060400,1,"Block Group 1, Census Tract 604, Dutchess County, New York",257,142,399,145,55,4,0,19,34,0,142,399,33,16,17,65,11,257,2001.0,2010.0,2012.0,800.0,1158.0,1457.0,25.3,50125.0,758,36027060400
36,027,060400,2,"Block Group 2, Census Tract 604, Dutchess County, New York",401,211,612,203,102,8,0,8,80,1,211,612,22,19,46,101,22,401,2002.0,2010.0,2013.0,1244.0,1598.0,1940.0,24.6,81196.0,1369,36027060400
36,027,070101,1,"Block Group 1, Census Tract 701.01, Dutchess County, New York",223,177,400,132,30,0,0,0,61,0,177,400,73,18,10,58,18,223,1989.0,2008.0,2012.0,705.0,767.0,896.0,31.3,66818.0,1155,36027070101
36,027,070102,2,"Block Group 2, Census Tract 701.02, Dutchess County, New York",179,423,602,50,21,0,35,0,73,26,423,602,44,59,147,129,18,179,1997.0,2001.0,2007.0,631.0,698.0,958.0,26.3,61600.0,1827,36027070102
36,027,070102,3,"Block Group 3, Census Tract 701.02, Dutchess County, New York",50,376,426,35,0,0,0,7,8,0,376,426,76,79,72,88,61,50,1995.0,1997.0,2011.0,888.0,986.0,1365.0,26.7,54500.0,1208,36027070102
36,027,070201,1,"Block Group 1, Census Tract 702.01, Dutchess County, New York",85,543,628,44,21,0,0,10,10,9,543,628,141,83,117,134,59,85,1994.0,1997.0,2013.0,681.0,1042.0,1146.0,30.7,90479.0,1551,36027070201
36,027,070201,2,"Block Group 2, Census Tract 702.01, Dutchess County, New York",96,137,233,49,0,0,0,0,47,3,137,233,36,28,25,45,0,96,1992.0,2003.0,2010.0,609.0,725.0,956.0,50.0,55694.0,592,36027070201
36,027,070201,3,"Block Group 3, Census Tract 702.01, Dutchess County, New York",275,86,361,128,96,0,0,26,25,0,86,361,20,0,17,49,0,275,2001.0,2012.0,2013.0,643.0,1024.0,1194.0,32.9,52768.0,811,36027070201
36,027,070301,1,"Block Group 1, Census Tract 703.01, Dutchess County, New York",54,434,488,36,0,0,0,15,3,12,434,488,115,22,78,161,46,54,2000.0,2001.0,2011.0,1368.0,1486.0,1734.0,50.0,84808.0,1324,36027070301
36,027,070301,2,"Block Group 2, Census Tract 703.01, Dutchess County, New York",107,326,433,51,0,0,0,0,56,0,326,433,0,71,117,106,32,107,1998.0,2002.0,2010.0,1129.0,1382.0,1479.0,50.0,79063.0,1518,36027070301
36,027,070301,3,"Block Group 3, Census Tract 703.01, Dutchess County, New York",14,622,636,14,0,0,0,0,0,22,622,636,114,52,148,197,89,14,2000.0,2000.0,,,,,,104286.0,1776,36027070301
36,027,070301,4,"Block Group 4, Census Tract 703.01, Dutchess County, New York",357,283,640,102,0,0,0,138,117,0,283,640,50,22,82,129,0,357,1998.0,2001.0,2003.0,717.0,775.0,866.0,37.2,40250.0,1043,36027070301
36,027,070401,1,"Block Group 1, Census Tract 704.01, Dutchess County, New York",142,626,768,115,20,0,0,0,7,25,626,768,138,100,62,271,30,142,2000.0,2003.0,2013.0,1056.0,1164.0,1301.0,28.4,94167.0,1893,36027070401
36,027,070401,2,"Block Group 2, Census Tract 704.01, Dutchess County, New York",23,0,23,23,0,0,0,0,0,0,0,23,0,0,0,0,0,23,,,,,,,,,1771,36027070401
36,027,070401,3,"Block Group 3, Census Tract 704.01, Dutchess County, New York",77,296,373,77,0,0,0,0,0,0,296,373,94,35,68,67,32,77,1993.0,1998.0,2012.0,933.0,1623.0,1811.0,28.9,63194.0,1131,36027070401
36,027,080103,1,"Block Group 1, Census Tract 801.03, Dutchess County, New York",0,634,634,0,0,0,0,0,0,10,634,634,74,58,173,228,91,0,2001.0,2001.0,,,,,,122500.0,1848,36027080103
36,027,080103,2,"Block Group 2, Census Tract 801.03, Dutchess County, New York",41,459,500,0,10,0,0,31,0,0,459,500,87,56,98,167,51,41,1999.0,1998.0,,,,,,104286.0,1640,36027080103
36,027,080103,3,"Block Group 3, Census Tract 801.03, Dutchess County, New York",18,432,450,18,0,0,0,0,0,15,432,450,20,44,113,197,43,18,2002.0,2002.0,,,,,,125417.0,1418,36027080103
36,027,080104,1,"Block Group 1, Census Tract 801.04, Dutchess County, New York",51,424,475,0,7,0,0,11,33,16,424,475,64,97,112,93,42,51,1995.0,1996.0,2004.0,1570.0,1713.0,1857.0,50.0,84125.0,1256,36027080104
36,001,014302,1,"Block Group 1, Census Tract 143.02, Albany County, New York",85,941,1026,70,15,0,0,0,0,47,941,1026,69,18,204,451,152,85,2004.0,2005.0,2013.0,1267.0,1363.0,1459.0,22.9,127500.0,3146,36001014302
36,001,014302,2,"Block Group 2, Census Tract 143.02, Albany County, New York",81,428,509,16,0,0,0,0,65,56,428,509,15,92,95,124,46,81,2001.0,2003.0,2006.0,469.0,489.0,634.0,18.9,54448.0,1092,36001014302
36,071,013201,3,"Block Group 3, Census Tract 132.01, Orange County, New York",344,257,601,161,51,11,18,15,88,0,257,601,24,35,15,158,25,344,2003.0,2007.0,2011.0,702.0,754.0,1016.0,41.1,35430.0,1015,36071013201
36,071,013201,4,"Block Group 4, Census Tract 132.01, Orange County, New York",0,619,619,0,0,0,0,0,0,24,619,619,19,118,200,216,42,0,1999.0,1999.0,,,,,,123309.0,2389,36071013201
36,071,013202,1,"Block Group 1, Census Tract 132.02, Orange County, New York",58,381,439,33,4,0,0,0,21,26,381,439,23,49,35,161,87,58,2005.0,2006.0,2011.0,,900.0,,29.2,62542.0,1217,36071013202
36,071,013202,2,"Block Group 2, Census Tract 132.02, Orange County, New York",71,267,338,34,0,0,0,16,21,18,267,338,19,35,90,65,40,71,1999.0,2001.0,2009.0,692.0,823.0,880.0,12.1,92333.0,837,36071013202
36,071,014101,1,"Block Group 1, Census Tract 141.01, Orange County, New York",129,164,293,85,0,0,0,0,44,0,164,293,13,37,16,78,20,129,2002.0,2007.0,2011.0,855.0,1136.0,1783.0,17.8,76523.0,780,36071014101
36,071,014101,2,"Block Group 2, Census Tract 141.01, Orange County, New York",198,254,452,51,33,0,0,7,107,27,254,452,52,4,39,23,109,198,2010.0,2010.0,2009.0,843.0,1271.0,1481.0,47.3,47214.0,1452,36071014101
36,071,014101,3,"Block Group 3, Census Tract 141.01, Orange County, New York",74,510,584,49,6,0,0,6,13,6,510,584,41,23,163,178,99,74,2002.0,2003.0,2012.0,1314.0,1408.0,1513.0,22.6,102500.0,1723,36071014101
36,071,014102,1,"Block Group 1, Census Tract 141.02, Orange County, New York",276,337,613,101,41,0,20,15,99,0,337,613,8,5,5,272,47,276,2006.0,2007.0,2010.0,1339.0,1458.0,1759.0,25.8,89712.0,2466,36071014102
36,071,014102,2,"Block Group 2, Census Tract 141.02, Orange County, New York",437,560,997,188,83,0,15,18,133,32,560,997,10,95,169,199,55,437,2000.0,2006.0,2011.0,863.0,1234.0,1471.0,29.5,83110.0,2719,36071014102
36,071,014102,3,"Block Group 3, Census Tract 141.02, Orange County, New York",61,209,270,30,0,0,0,0,31,0,209,270,47,36,35,62,29,61,1996.0,2002.0,2010.0,1144.0,1558.0,1779.0,22.5,96500.0,1122,36071014102
36,071,014501,1,"Block Group 1, Census Tract 145.01, Orange County, New York",92,538,630,28,0,0,0,0,64,16,538,630,92,32,86,221,91,92,2003.0,2004.0,2007.0,937.0,975.0,1398.0,50.0,101364.0,1785,36071014501
36,071,014501,2,"Block Group 2, Census Tract 145.01, Orange County, New York",18,296,314,10,0,0,0,0,8,19,296,314,49,60,39,111,18,18,2000.0,2001.0,,,,,,108611.0,923,36071014501
36,071,014501,3,"Block Group 3, Census Tract 145.01, Orange County, New York",17,443,460,0,8,9,0,0,0,10,443,460,51,50,86,183,63,17,2002.0,2002.0,2018.0,,1109.0,1217.0,22.2,96563.0,1357,36071014501
36,071,014502,1,"Block Group 1, Census Tract 145.02, Orange County, New York",332,485,817,228,13,0,0,28,63,26,485,817,67,36,80,220,56,332,2003.0,2007.0,2012.0,702.0,820.0,891.0,35.5,67404.0,1978,36071014502
36,071,014502,2,"Block Group 2, Census Tract 145.02, Orange County, New York",15,406,421,0,0,0,0,15,0,0,406,421,131,42,105,79,49,15,1993.0,1993.0,,,,,,79083.0,926,36071014502
36,071,014502,3,"Block Group 3, Census Tract 145.02, Orange County, New York",87,638,725,0,14,16,16,13,28,0,638,725,116,79,82,254,107,87,2002.0,2001.0,1999.0,1207.0,1402.0,2164.0,12.1,112023.0,2019,36071014502
36,071,015003,1,"Block Group 1, Census Tract 150.03, Orange County, New York",485,243,728,274,57,0,16,18,120,0,243,728,0,0,19,90,134,485,2010.0,2011.0,2012.0,638.0,893.0,1198.0,50.0,27155.0,4335,36071015003
36,071,015003,2,"Block Group 2, Census Tract 150.03, Orange County, New York",224,45,269,112,18,5,30,18,41,0,45,269,0,26,19,0,0,224,1989.0,2009.0,2011.0,547.0,722.0,1050.0,39.2,31823.0,1246,36071015003
36,025,971400,4,"Block Group 4, Census Tract 9714, Delaware County, New York",112,187,299,61,34,0,0,10,7,12,187,299,39,20,41,58,17,112,1998.0,2006.0,2013.0,348.0,515.0,563.0,29.1,31406.0,760,36025971400
36,027,010000,4,"Block Group 4, Census Tract 100, Dutchess County, New York",65,180,245,28,18,0,0,19,0,0,180,245,35,67,44,28,6,65,1988.0,1993.0,2012.0,479.0,562.0,928.0,18.5,50104.0,647,36027010000
36,027,020003,1,"Block Group 1, Census Tract 200.03, Dutchess County, New York",31,377,408,24,7,0,0,0,0,0,377,408,0,26,113,187,51,31,2003.0,2003.0,2013.0,,,,23.1,103438.0,1204,36027020003
36,027,020003,2,"Block Group 2, Census Tract 200.03, Dutchess County, New York",17,276,293,17,0,0,0,0,0,12,276,293,36,10,88,110,20,17,2000.0,2001.0,2016.0,1510.0,952.0,1948.0,43.1,37639.0,763,36027020003
36,027,020003,3,"Block Group 3, Census Tract 200.03, Dutchess County, New York",54,350,404,10,28,0,0,0,16,0,350,404,26,25,153,92,54,54,1998.0,2000.0,2016.0,829.0,857.0,886.0,14.0,100341.0,1015,36027020003
36,027,020003,4,"Block Group 4, Census Tract 200.03, Dutchess County, New York",48,414,462,36,5,0,0,7,0,9,414,462,57,46,137,141,24,48,1998.0,1999.0,2012.0,1150.0,1571.0,1786.0,46.3,91333.0,1316,36027020003
36,111,951100,2,"Block Group 2, Census Tract 9511, Ulster County, New York",15,336,351,0,0,6,0,0,9,8,336,351,69,47,51,47,114,15,2000.0,2000.0,2003.0,,,,,98558.0,682,36111951100
36,111,951100,1,"Block Group 1, Census Tract 9511, Ulster County, New York",86,302,388,78,0,0,0,0,8,0,302,388,84,18,88,61,51,86,1996.0,2001.0,2012.0,949.0,998.0,1122.0,50.0,29375.0,817,36111951100
36,111,951100,3,"Block Group 3, Census Tract 9511, Ulster County, New York",44,339,383,32,0,0,0,0,12,11,339,383,63,24,79,135,27,44,2000.0,2002.0,,,,,,128274.0,862,36111951100
36,111,951800,1,"Block Group 1, Census Tract 9518, Ulster County, New York",372,349,721,172,26,5,5,38,126,16,349,721,82,40,48,113,50,372,2000.0,2006.0,2010.0,480.0,683.0,975.0,33.0,35759.0,1680,36111951800
36,111,953000,2,"Block Group 2, Census Tract 9530, Ulster County, New York",110,184,294,34,41,6,7,0,22,0,184,294,11,32,47,73,21,110,2000.0,2005.0,2013.0,642.0,736.0,1310.0,50.0,44667.0,681,36111953000
36,111,953000,1,"Block Group 1, Census Tract 9530, Ulster County, New York",76,373,449,34,0,0,14,0,28,6,373,449,35,21,94,168,49,76,2002.0,2003.0,2009.0,678.0,732.0,864.0,20.8,75781.0,1226,36111953000
36,111,954900,1,"Block Group 1, Census Tract 9549, Ulster County, New York",163,407,570,139,5,0,0,0,19,0,407,570,98,56,147,89,17,163,1993.0,1999.0,2013.0,862.0,1044.0,1207.0,50.0,61500.0,1368,36111954900
36,111,951700,2,"Block Group 2, Census Tract 9517, Ulster County, New York",396,373,769,184,24,0,0,36,152,12,373,769,115,116,42,61,27,396,1986.0,2004.0,2010.0,431.0,686.0,866.0,32.9,24863.0,2029,36111951700
36,111,951700,3,"Block Group 3, Census Tract 9517, Ulster County, New York",264,29,293,16,121,0,0,90,37,0,29,293,17,0,0,0,12,264,,2010.0,2012.0,685.0,863.0,1097.0,36.7,40160.0,613,36111951700
36,111,951700,1,"Block Group 1, Census Tract 9517, Ulster County, New York",47,190,237,36,11,0,0,0,0,47,190,237,39,10,28,36,30,47,2005.0,2010.0,2010.0,,,824.0,30.9,36493.0,487,36111951700
36,111,951700,4,"Block Group 4, Census Tract 9517, Ulster County, New York",460,279,739,82,213,11,0,57,97,11,279,739,33,67,34,102,32,460,2001.0,2008.0,2014.0,871.0,969.0,1159.0,29.3,57380.0,1808,36111951700
36,111,954200,3,"Block Group 3, Census Tract 9542, Ulster County, New York",124,331,455,28,42,0,0,0,54,13,331,455,17,41,163,97,0,124,1997.0,2000.0,2011.0,998.0,1082.0,1166.0,36.4,83661.0,1187,36111954200
36,111,954200,1,"Block Group 1, Census Tract 9542, Ulster County, New York",27,396,423,0,16,0,0,0,11,0,396,423,78,45,65,106,102,27,2001.0,2002.0,2007.0,618.0,,,17.7,70884.0,1071,36111954200
36,111,954200,4,"Block Group 4, Census Tract 9542, Ulster County, New York",106,326,432,75,15,0,0,0,16,19,326,432,14,58,123,56,56,106,1997.0,2003.0,2012.0,1125.0,1250.0,1429.0,33.5,97667.0,1576,36111954200
36,111,953600,1,"Block Group 1, Census Tract 9536, Ulster County, New York",114,306,420,101,0,0,0,0,13,0,306,420,83,34,91,86,12,114,1994.0,2000.0,2012.0,822.0,863.0,908.0,39.1,83636.0,1061,36111953600
36,111,953800,1,"Block Group 1, Census Tract 9538, Ulster County, New York",135,401,536,105,7,0,6,0,17,17,401,536,27,59,105,175,18,135,2001.0,2004.0,2012.0,649.0,1029.0,1245.0,24.1,79688.0,1300,36111953800
36,111,953800,3,"Block Group 3, Census Tract 9538, Ulster County, New York",177,440,617,91,63,7,16,0,0,18,440,617,46,84,31,116,145,177,2005.0,2010.0,2014.0,666.0,810.0,955.0,27.0,73938.0,1480,36111953800
36,111,953800,2,"Block Group 2, Census Tract 9538, Ulster County, New York",266,194,460,103,52,10,20,26,55,0,194,460,43,15,67,43,26,266,1996.0,2005.0,2011.0,557.0,733.0,850.0,36.7,55556.0,1001,36111953800
36,111,950400,1,"Block Group 1, Census Tract 9504, Ulster County, New York",43,271,314,34,0,0,0,9,0,0,271,314,33,68,56,86,28,43,1996.0,1999.0,2012.0,939.0,1302.0,1401.0,22.6,77167.0,648,36111950400
36,111,950400,6,"Block Group 6, Census Tract 9504, Ulster County, New York",47,232,279,25,0,0,0,0,22,0,232,279,26,34,23,127,22,47,2003.0,2004.0,2010.0,714.0,742.0,1116.0,50.0,45625.0,751,36111950400
36,111,950400,3,"Block Group 3, Census Tract 9504, Ulster County, New York",52,252,304,9,15,0,0,0,28,0,252,304,25,43,35,141,8,52,2002.0,2003.0,2009.0,700.0,783.0,833.0,50.0,87778.0,641,36111950400
36,111,950400,4,"Block Group 4, Census Tract 9504, Ulster County, New York",101,191,292,87,0,7,0,7,0,0,191,292,32,50,65,35,9,101,1992.0,1998.0,2012.0,721.0,806.0,888.0,45.7,65263.0,796,36111950400
36,111,950400,2,"Block Group 2, Census Tract 9504, Ulster County, New York",33,180,213,23,10,0,0,0,0,15,180,213,32,18,8,75,32,33,2004.0,2006.0,2014.0,955.0,1271.0,1385.0,37.8,46198.0,840,36111950400
36,111,950400,5,"Block Group 5, Census Tract 9504, Ulster County, New York",68,204,272,12,15,0,0,0,41,8,204,272,17,39,68,46,26,68,1997.0,2001.0,2008.0,412.0,915.0,913.0,48.0,61500.0,559,36111950400
36,111,951200,3,"Block Group 3, Census Tract 9512, Ulster County, New York",0,498,498,0,0,0,0,0,0,26,498,498,123,50,68,136,95,0,2001.0,2001.0,,,,,,114444.0,1184,36111951200
36,111,951200,2,"Block Group 2, Census Tract 9512, Ulster County, New York",53,388,441,0,30,0,0,0,23,0,388,441,66,78,163,81,0,53,1993.0,1995.0,2016.0,779.0,1040.0,1190.0,51.0,63795.0,898,36111951200
36,111,951200,4,"Block Group 4, Census Tract 9512, Ulster County, New York",8,398,406,0,0,0,0,0,8,10,398,406,139,45,38,134,32,8,1994.0,1995.0,,,,,,77738.0,1006,36111951200
36,111,951200,1,"Block Group 1, Census Tract 9512, Ulster County, New York",37,266,303,29,8,0,0,0,0,18,266,303,52,54,57,19,66,37,1995.0,1998.0,2013.0,,1294.0,1397.0,51.0,53472.0,719,36111951200
36,111,952000,1,"Block Group 1, Census Tract 9520, Ulster County, New York",272,181,453,101,61,0,0,0,110,0,181,453,40,17,9,48,67,272,2005.0,2010.0,2011.0,691.0,864.0,1093.0,29.0,44125.0,1252,36111952000
36,111,952000,2,"Block Group 2, Census Tract 9520, Ulster County, New York",347,167,514,134,107,10,0,30,66,6,167,514,37,12,9,85,18,347,2003.0,2010.0,2013.0,768.0,859.0,1047.0,50.0,26618.0,1371,36111952000
36,111,954000,3,"Block Group 3, Census Tract 9540, Ulster County, New York",55,732,787,16,27,0,0,0,12,0,732,787,118,93,113,345,63,55,2001.0,2002.0,2015.0,506.0,1240.0,1373.0,49.7,71125.0,2140,36111954000
36,111,954000,2,"Block Group 2, Census Tract 9540, Ulster County, New York",132,629,761,64,0,0,39,0,29,74,629,761,83,66,153,175,78,132,2001.0,2002.0,2009.0,492.0,641.0,931.0,32.9,56341.0,1451,36111954000
36,111,954000,1,"Block Group 1, Census Tract 9540, Ulster County, New York",243,361,604,114,43,0,13,16,57,0,361,604,100,12,14,172,63,243,2003.0,2006.0,2012.0,613.0,822.0,899.0,18.3,83837.0,1441,36111954000
36,111,952700,2,"Block Group 2, Census Tract 9527, Ulster County, New York",104,203,307,53,0,0,0,10,41,7,203,307,19,75,16,72,14,104,1995.0,2003.0,2010.0,709.0,763.0,1258.0,23.1,59107.0,781,36111952700
36,111,952700,3,"Block Group 3, Census Tract 9527, Ulster County, New York",210,358,568,96,69,19,0,0,26,12,358,568,129,26,50,119,22,210,1995.0,2004.0,2013.0,826.0,918.0,1121.0,23.8,57741.0,1187,36111952700
36,111,952700,1,"Block Group 1, Census Tract 9527, Ulster County, New York",40,251,291,8,0,0,8,0,24,0,251,291,62,46,29,76,38,40,1996.0,2000.0,2005.0,,,,,83092.0,755,36111952700
36,111,953400,3,"Block Group 3, Census Tract 9534, Ulster County, New York",246,254,500,157,16,0,0,0,73,44,254,500,26,21,34,38,91,246,2010.0,2011.0,2012.0,928.0,1094.0,1407.0,35.8,59167.0,959,36111953400
36,111,953400,2,"Block Group 2, Census Tract 9534, Ulster County, New York",488,175,663,305,50,0,0,42,91,0,175,663,52,8,26,33,56,488,2000.0,2011.0,2012.0,922.0,994.0,1471.0,39.6,40417.0,1374,36111953400
36,111,953400,1,"Block Group 1, Census Tract 9534, Ulster County, New York",9,262,271,3,6,0,0,0,0,0,262,271,25,63,17,123,34,9,2002.0,2002.0,2013.0,,,,,108281.0,787,36111953400
36,111,954700,2,"Block Group 2, Census Tract 9547, Ulster County, New York",154,190,344,60,18,0,0,21,55,8,190,344,19,11,67,68,17,154,2000.0,2004.0,2010.0,752.0,831.0,999.0,35.6,57143.0,850,36111954700
36,111,954700,1,"Block Group 1, Census Tract 9547, Ulster County, New York",98,224,322,42,5,0,12,0,39,0,224,322,54,83,27,44,16,98,1987.0,1994.0,2009.0,803.0,842.0,881.0,50.0,41689.0,870,36111954700
36,111,950300,3,"Block Group 3, Census Tract 9503, Ulster County, New York",300,360,660,121,89,16,0,19,55,10,360,660,143,42,59,90,16,300,1989.0,2004.0,2012.0,813.0,931.0,998.0,37.3,50000.0,1905,36111950300
36,111,950300,1,"Block Group 1, Census Tract 9503, Ulster County, New York",277,410,687,146,44,17,0,23,47,0,410,687,121,8,34,220,27,277,2002.0,2005.0,2012.0,767.0,908.0,1081.0,33.7,59866.0,1787,36111950300
36,111,950300,2,"Block Group 2, Census Tract 9503, Ulster County, New York",16,374,390,0,0,10,6,0,0,0,374,390,113,72,101,80,8,16,1990.0,1989.0,1989.0,,,,,67672.0,882,36111950300
36,111,951000,4,"Block Group 4, Census Tract 9510, Ulster County, New York",101,477,578,82,0,0,9,10,0,0,477,578,59,86,169,65,98,101,1996.0,1998.0,2012.0,,823.0,862.0,50.0,64167.0,1313,36111951000
36,111,951000,2,"Block Group 2, Census Tract 9510, Ulster County, New York",166,396,562,151,0,0,0,0,15,11,396,562,85,20,43,191,46,166,2003.0,2006.0,2013.0,751.0,797.0,1029.0,45.5,55833.0,1360,36111951000
36,111,951000,3,"Block Group 3, Census Tract 9510, Ulster County, New York",87,418,505,87,0,0,0,0,0,52,418,505,80,53,94,114,25,87,1998.0,2002.0,,532.0,730.0,771.0,33.0,66034.0,1043,36111951000
36,111,951000,1,"Block Group 1, Census Tract 9510, Ulster County, New York",59,224,283,59,0,0,0,0,0,0,224,283,38,93,15,78,0,59,1988.0,1997.0,2012.0,816.0,877.0,1095.0,17.4,65083.0,617,36111951000
36,111,951400,1,"Block Group 1, Census Tract 9514, Ulster County, New York",202,393,595,40,81,0,0,18,63,0,393,595,56,50,106,112,69,202,1999.0,2004.0,2013.0,710.0,788.0,942.0,50.0,41208.0,1391,36111951400
36,111,951400,3,"Block Group 3, Census Tract 9514, Ulster County, New York",125,327,452,86,0,7,0,0,32,10,327,452,71,77,61,55,53,125,1993.0,2001.0,2011.0,1200.0,1328.0,1414.0,50.0,54632.0,1076,36111951400
36,111,951400,2,"Block Group 2, Census Tract 9514, Ulster County, New York",514,164,678,241,62,8,26,28,149,0,164,678,76,25,29,24,10,514,1982.0,2008.0,2011.0,640.0,870.0,1072.0,50.0,21786.0,1165,36111951400
36,111,950100,1,"Block Group 1, Census Tract 9501, Ulster County, New York",89,358,447,19,43,0,0,14,13,9,358,447,108,56,41,92,52,89,1994.0,2000.0,2015.0,830.0,1032.0,1141.0,50.0,51118.0,973,36111950100
36,111,950100,2,"Block Group 2, Census Tract 9501, Ulster County, New York",44,263,307,11,0,0,0,0,33,0,263,307,61,59,31,78,34,44,1994.0,2000.0,2006.0,759.0,813.0,857.0,,70188.0,721,36111950100
36,111,950100,3,"Block Group 3, Census Tract 9501, Ulster County, New York",50,350,400,12,29,0,0,0,9,0,350,400,33,105,50,49,113,50,1997.0,2002.0,2016.0,806.0,1034.0,1142.0,30.7,81058.0,1344,36111950100
36,071,014301,2,"Block Group 2, Census Tract 143.01, Orange County, New York",218,229,447,163,10,0,0,0,45,12,229,447,40,6,59,92,20,218,2001.0,2009.0,2012.0,750.0,966.0,1503.0,50.0,53523.0,1402,36071014301
36,071,014301,3,"Block Group 3, Census Tract 143.01, Orange County, New York",74,244,318,27,8,0,0,29,10,0,244,318,68,27,50,78,21,74,1995.0,1998.0,2008.0,1008.0,1000.0,1171.0,26.7,105500.0,916,36071014301
36,071,014301,1,"Block Group 1, Census Tract 143.01, Orange County, New York",14,357,371,0,0,0,0,6,8,33,357,371,69,28,113,87,27,14,1997.0,1997.0,2016.0,,800.0,1125.0,22.5,113194.0,1120,36071014301
36,071,010700,5,"Block Group 5, Census Tract 107, Orange County, New York",283,151,434,159,55,0,0,10,59,0,151,434,0,9,22,120,0,283,2004.0,2010.0,2012.0,745.0,820.0,1103.0,18.5,68750.0,1215,36071010700
36,071,010700,4,"Block Group 4, Census Tract 107, Orange County, New York",82,365,447,82,0,0,0,0,0,10,365,447,48,59,113,125,10,82,1997.0,2000.0,2013.0,,,,,65924.0,1484,36071010700
36,071,010700,3,"Block Group 3, Census Tract 107, Orange County, New York",80,161,241,11,47,0,0,0,22,10,161,241,22,15,54,60,0,80,1998.0,2004.0,2016.0,850.0,980.0,1357.0,22.4,84403.0,646,36071010700
36,071,010700,2,"Block Group 2, Census Tract 107, Orange County, New York",212,212,424,70,17,0,0,18,107,18,212,424,48,19,35,92,0,212,2000.0,2005.0,2008.0,716.0,1050.0,1209.0,29.9,59271.0,1123,36071010700
36,071,010700,6,"Block Group 6, Census Tract 107, Orange County, New York",110,280,390,46,33,0,0,0,31,0,280,390,48,23,108,101,0,110,1996.0,2001.0,2013.0,794.0,930.0,965.0,38.5,70547.0,1370,36071010700
36,071,010700,1,"Block Group 1, Census Tract 107, Orange County, New York",11,301,312,11,0,0,0,0,0,10,301,312,47,81,29,101,33,11,1998.0,2000.0,,,,,,102500.0,943,36071010700
36,071,011900,1,"Block Group 1, Census Tract 119, Orange County, New York",94,541,635,48,0,0,0,11,35,0,541,635,130,27,101,212,71,94,2001.0,2002.0,2010.0,851.0,1205.0,1565.0,29.1,105163.0,2949,36071011900
36,071,011900,3,"Block Group 3, Census Tract 119, Orange County, New York",23,371,394,0,0,11,0,12,0,0,371,394,29,41,169,113,19,23,1997.0,1996.0,,,,,,88750.0,1183,36071011900
36,071,011900,2,"Block Group 2, Census Tract 119, Orange County, New York",186,463,649,71,0,8,0,29,78,14,463,649,103,17,72,109,148,186,2004.0,2005.0,2007.0,926.0,983.0,1157.0,13.4,99570.0,1953,36071011900
36,001,014401,1,"Block Group 1, Census Tract 144.01, Albany County, New York",136,348,484,27,8,0,48,9,44,0,348,484,28,75,89,88,68,136,1998.0,1999.0,2003.0,546.0,578.0,698.0,14.8,63611.0,1180,36001014401
36,001,014401,3,"Block Group 3, Census Tract 144.01, Albany County, New York",47,503,550,32,0,0,5,10,0,10,503,550,130,46,110,114,93,47,1997.0,1998.0,2011.0,,,,,76875.0,1571,36001014401
36,071,011900,4,"Block Group 4, Census Tract 119, Orange County, New York",73,0,73,8,0,0,0,0,65,0,0,73,0,0,0,0,0,73,,2006.0,2006.0,231.0,790.0,827.0,34.2,12457.0,389,36071011900
36,071,012800,2,"Block Group 2, Census Tract 128, Orange County, New York",23,569,592,23,0,0,0,0,0,55,569,592,68,33,184,151,78,23,2000.0,2001.0,2010.0,,,1368.0,51.0,111250.0,1599,36071012800
36,071,012800,1,"Block Group 1, Census Tract 128, Orange County, New York",5,184,189,0,0,5,0,0,0,4,184,189,55,31,35,59,0,5,1992.0,1991.0,,,,,,110563.0,450,36071012800
36,071,012800,3,"Block Group 3, Census Tract 128, Orange County, New York",395,491,886,97,115,0,0,0,183,10,491,886,25,81,161,107,107,395,1999.0,2006.0,2011.0,694.0,1046.0,1213.0,31.6,73500.0,2260,36071012800
36,071,012800,4,"Block Group 4, Census Tract 128, Orange County, New York",0,229,229,0,0,0,0,0,0,12,229,229,66,12,37,62,40,0,2000.0,2000.0,,,,,,78295.0,525,36071012800
36,071,013500,3,"Block Group 3, Census Tract 135, Orange County, New York",173,857,1030,33,59,0,0,10,71,70,857,1030,28,156,125,400,78,173,2003.0,2004.0,2011.0,861.0,1115.0,1884.0,17.6,111932.0,2791,36071013500
36,071,013500,2,"Block Group 2, Census Tract 135, Orange County, New York",0,354,354,0,0,0,0,0,0,15,354,354,35,75,111,118,0,0,1996.0,1996.0,,,,,,133333.0,1049,36071013500
36,071,013500,1,"Block Group 1, Census Tract 135, Orange County, New York",80,523,603,35,0,0,0,0,45,0,523,603,21,75,74,311,42,80,2003.0,2004.0,2009.0,813.0,903.0,1261.0,35.4,144196.0,2428,36071013500
36,071,014201,2,"Block Group 2, Census Tract 142.01, Orange County, New York",53,333,386,25,9,0,0,0,19,21,333,386,65,21,71,84,71,53,2001.0,2003.0,2012.0,527.0,,1651.0,30.8,108810.0,1143,36071014201
36,071,014201,1,"Block Group 1, Census Tract 142.01, Orange County, New York",28,314,342,0,0,0,0,0,28,0,314,342,51,39,62,126,36,28,2000.0,2001.0,2006.0,,,,28.3,105714.0,1019,36071014201
36,071,014201,3,"Block Group 3, Census Tract 142.01, Orange County, New York",9,499,508,0,0,0,0,0,9,27,499,508,50,77,138,139,68,9,1999.0,1999.0,,,,,,103214.0,1606,36071014201
36,071,014202,2,"Block Group 2, Census Tract 142.02, Orange County, New York",28,321,349,0,16,0,0,0,12,0,321,349,32,10,50,101,128,28,2007.0,2007.0,2016.0,2396.0,2635.0,2817.0,35.6,193250.0,1380,36071014202
36,071,014202,5,"Block Group 5, Census Tract 142.02, Orange County, New York",34,335,369,21,13,0,0,0,0,9,335,369,78,28,76,118,26,34,1998.0,2000.0,,,,,,145083.0,1379,36071014202
36,071,014202,4,"Block Group 4, Census Tract 142.02, Orange County, New York",74,486,560,0,74,0,0,0,0,18,486,560,67,83,83,158,77,74,2001.0,2003.0,,,,,,131198.0,1694,36071014202
36,071,014202,1,"Block Group 1, Census Tract 142.02, Orange County, New York",16,252,268,16,0,0,0,0,0,35,252,268,51,50,65,51,0,16,1994.0,1995.0,,,,,,81797.0,807,36071014202
36,071,014202,3,"Block Group 3, Census Tract 142.02, Orange County, New York",88,311,399,59,29,0,0,0,0,0,311,399,14,56,162,66,13,88,1995.0,1998.0,2014.0,1167.0,1486.0,1744.0,45.0,93359.0,765,36071014202
36,071,012100,5,"Block Group 5, Census Tract 121, Orange County, New York",9,318,327,9,0,0,0,0,0,0,318,327,93,45,71,100,9,9,1993.0,1994.0,,,,,,118375.0,1029,36071012100
36,071,012100,1,"Block Group 1, Census Tract 121, Orange County, New York",178,197,375,95,52,0,0,0,31,13,197,375,36,20,32,80,16,178,2001.0,2009.0,2013.0,781.0,877.0,1168.0,50.0,64107.0,831,36071012100
36,071,012100,2,"Block Group 2, Census Tract 121, Orange County, New York",38,37,75,25,6,0,7,0,0,0,37,75,19,0,0,18,0,38,1979.0,2006.0,2012.0,,1060.0,1192.0,16.2,98565.0,119,36071012100
36,071,012100,4,"Block Group 4, Census Tract 121, Orange County, New York",403,116,519,157,36,0,0,39,171,0,116,519,15,0,29,28,44,403,2005.0,2009.0,2010.0,901.0,996.0,1953.0,47.8,31652.0,1266,36071012100
36,071,012100,3,"Block Group 3, Census Tract 121, Orange County, New York",103,73,176,53,0,0,0,10,40,14,73,176,23,0,0,26,10,103,2005.0,2008.0,2010.0,1184.0,1320.0,1429.0,18.6,95385.0,424,36071012100
36,105,951900,1,"Block Group 1, Census Tract 9519, Sullivan County, New York",10,153,163,5,0,0,0,5,0,49,153,163,32,6,21,45,0,10,2004.0,2004.0,,,,,,60855.0,662,36105951900
36,105,950200,1,"Block Group 1, Census Tract 9502, Sullivan County, New York",131,233,364,52,0,14,19,0,46,0,233,364,35,20,57,60,61,131,2001.0,2003.0,2007.0,625.0,725.0,879.0,50.0,49531.0,963,36105950200
36,105,950200,3,"Block Group 3, Census Tract 9502, Sullivan County, New York",75,207,282,6,0,0,42,6,21,0,207,282,41,19,89,46,12,75,1995.0,1994.0,1989.0,605.0,625.0,645.0,13.9,34145.0,524,36105950200
36,105,950200,4,"Block Group 4, Census Tract 9502, Sullivan County, New York",55,250,305,18,0,0,0,0,37,10,250,305,28,24,64,88,36,55,2001.0,2003.0,2007.0,,850.0,1066.0,14.8,51976.0,682,36105950200
36,105,950200,5,"Block Group 5, Census Tract 9502, Sullivan County, New York",141,151,292,40,68,0,0,0,33,0,151,292,28,11,25,56,31,141,2002.0,2009.0,2015.0,703.0,758.0,792.0,37.0,32045.0,735,36105950200
36,105,950400,2,"Block Group 2, Census Tract 9504, Sullivan County, New York",36,384,420,30,0,0,0,0,6,7,384,420,133,20,40,116,68,36,2000.0,2001.0,2012.0,523.0,546.0,822.0,18.3,67500.0,1067,36105950400
36,105,950400,1,"Block Group 1, Census Tract 9504, Sullivan County, New York",104,331,435,75,0,7,0,0,22,0,331,435,32,59,117,87,36,104,1996.0,2000.0,2012.0,398.0,615.0,842.0,11.5,72338.0,1151,36105950400
36,105,950900,3,"Block Group 3, Census Tract 9509, Sullivan County, New York",182,75,257,103,22,0,9,5,43,0,75,257,34,12,18,0,11,182,1983.0,2010.0,2012.0,332.0,530.0,799.0,29.6,30156.0,1093,36105950900
36,105,950900,1,"Block Group 1, Census Tract 9509, Sullivan County, New York",99,168,267,67,32,0,0,0,0,0,168,267,104,9,0,44,11,99,1979.0,2005.0,2014.0,837.0,1021.0,1135.0,50.0,54063.0,732,36105950900
36,105,950900,2,"Block Group 2, Census Tract 9509, Sullivan County, New York",167,202,369,78,42,0,0,0,47,23,202,369,15,59,26,79,0,167,2000.0,2007.0,2012.0,,630.0,777.0,45.9,24512.0,970,36105950900
36,105,951000,2,"Block Group 2, Census Tract 9510, Sullivan County, New York",176,129,305,28,0,0,39,42,67,0,129,305,45,0,28,32,24,176,1997.0,2000.0,2001.0,99.0,668.0,588.0,19.2,38955.0,772,36105951000
36,105,951100,1,"Block Group 1, Census Tract 9511, Sullivan County, New York",101,235,336,46,0,0,0,12,43,16,235,336,13,30,55,87,34,101,2002.0,2004.0,2009.0,472.0,697.0,828.0,24.4,66000.0,1117,36105951100
36,105,951100,3,"Block Group 3, Census Tract 9511, Sullivan County, New York",61,150,211,32,16,0,7,0,6,0,150,211,16,43,38,48,5,61,1994.0,2000.0,2013.0,688.0,723.0,825.0,18.0,47321.0,475,36105951100
36,105,952100,1,"Block Group 1, Census Tract 9521, Sullivan County, New York",133,459,592,73,30,0,0,18,12,0,459,592,101,92,76,155,35,133,1995.0,2001.0,2013.0,588.0,838.0,890.0,22.5,66066.0,1611,36105952100
36,105,952100,2,"Block Group 2, Census Tract 9521, Sullivan County, New York",122,308,430,99,9,0,0,3,11,6,308,430,63,19,80,116,24,122,1999.0,2004.0,2012.0,521.0,652.0,681.0,17.7,57596.0,983,36105952100
36,105,952500,1,"Block Group 1, Census Tract 9525, Sullivan County, New York",61,178,239,31,8,0,0,0,22,8,178,239,40,6,22,80,22,61,2003.0,2005.0,2011.0,483.0,572.0,594.0,23.3,75365.0,617,36105952500
36,105,950500,2,"Block Group 2, Census Tract 9505, Sullivan County, New York",103,236,339,38,0,0,0,58,7,26,236,339,51,23,56,65,15,103,1998.0,1998.0,1999.0,360.0,614.0,638.0,33.9,,1047,36105950500
36,105,950500,3,"Block Group 3, Census Tract 9505, Sullivan County, New York",109,183,292,23,20,0,0,0,66,32,183,292,30,28,35,32,26,109,2000.0,2005.0,2008.0,668.0,685.0,1038.0,50.0,52054.0,644,36105950500
36,105,950500,1,"Block Group 1, Census Tract 9505, Sullivan County, New York",148,207,355,100,0,0,0,30,18,0,207,355,0,5,52,66,84,148,2007.0,2010.0,2011.0,609.0,648.0,722.0,50.0,56193.0,1070,36105950500
36,105,950500,4,"Block Group 4, Census Tract 9505, Sullivan County, New York",65,118,183,45,20,0,0,0,0,0,118,183,0,31,15,46,26,65,2003.0,2010.0,,,,,,66300.0,401,36105950500
36,105,950300,1,"Block Group 1, Census Tract 9503, Sullivan County, New York",53,460,513,23,4,6,9,0,11,18,460,513,102,42,144,111,43,53,1996.0,1997.0,2010.0,516.0,575.0,720.0,50.0,56042.0,1234,36105950300
36,105,950700,2,"Block Group 2, Census Tract 9507, Sullivan County, New York",342,124,466,150,95,0,8,0,89,0,124,466,7,24,11,70,12,342,2003.0,2011.0,2012.0,563.0,589.0,716.0,46.7,19716.0,1435,36105950700
36,105,950700,4,"Block Group 4, Census Tract 9507, Sullivan County, New York",290,268,558,222,24,0,0,26,18,0,268,558,35,54,19,129,31,290,2002.0,2010.0,2012.0,728.0,768.0,789.0,50.0,33542.0,1289,36105950700
36,105,950700,1,"Block Group 1, Census Tract 9507, Sullivan County, New York",179,119,298,117,26,0,0,0,36,0,119,298,44,7,17,27,24,179,1995.0,2011.0,2012.0,356.0,389.0,549.0,25.9,37181.0,807,36105950700
36,105,950700,3,"Block Group 3, Census Tract 9507, Sullivan County, New York",31,52,83,25,0,0,6,0,0,0,52,83,7,8,19,18,0,31,1996.0,2001.0,2012.0,776.0,910.0,1055.0,19.5,45625.0,238,36105950700
36,105,950700,5,"Block Group 5, Census Tract 9507, Sullivan County, New York",98,83,181,53,15,0,7,0,23,0,83,181,16,25,5,37,0,98,1991.0,2006.0,2012.0,621.0,691.0,855.0,21.7,62750.0,683,36105950700
36,105,951600,2,"Block Group 2, Census Tract 9516, Sullivan County, New York",72,228,300,39,0,0,0,0,33,8,228,300,26,41,32,98,23,72,2002.0,2004.0,2010.0,814.0,848.0,881.0,14.2,79457.0,971,36105951600
36,105,951600,4,"Block Group 4, Census Tract 9516, Sullivan County, New York",40,231,271,26,14,0,0,0,0,16,231,271,18,7,28,128,34,40,2005.0,2006.0,2014.0,729.0,933.0,1321.0,41.4,52411.0,934,36105951600
36,105,952400,1,"Block Group 1, Census Tract 9524, Sullivan County, New York",127,386,513,53,25,0,0,4,45,6,386,513,37,44,36,207,56,127,2004.0,2005.0,2011.0,814.0,851.0,887.0,41.8,50950.0,1241,36105952400
36,105,951300,3,"Block Group 3, Census Tract 9513, Sullivan County, New York",24,271,295,16,0,0,0,0,8,0,271,295,32,43,44,80,72,24,2002.0,2003.0,2008.0,,,,,84906.0,956,36105951300
36,105,951300,1,"Block Group 1, Census Tract 9513, Sullivan County, New York",164,415,579,36,62,0,0,39,27,0,415,579,52,59,73,124,107,164,2002.0,2004.0,2012.0,575.0,733.0,1012.0,21.6,58963.0,1342,36105951300
36,105,951300,4,"Block Group 4, Census Tract 9513, Sullivan County, New York",62,310,372,33,0,0,0,0,29,7,310,372,39,33,89,131,11,62,1999.0,2002.0,2010.0,809.0,850.0,891.0,45.0,49167.0,951,36105951300
36,001,014301,1,"Block Group 1, Census Tract 143.01, Albany County, New York",57,333,390,33,0,0,0,0,24,21,333,390,83,38,56,117,18,57,1998.0,2001.0,2011.0,673.0,663.0,705.0,27.8,83485.0,1020,36001014301
36,039,080700,3,"Block Group 3, Census Tract 807, Greene County, New York",175,301,476,94,34,5,0,12,30,6,301,476,22,14,112,103,44,175,2000.0,2005.0,2012.0,564.0,597.0,928.0,27.3,63250.0,1343,36039080700
36,039,080700,1,"Block Group 1, Census Tract 807, Greene County, New York",172,146,318,99,25,0,0,0,48,6,146,318,8,23,51,47,11,172,1998.0,2008.0,2012.0,128.0,313.0,463.0,30.9,28190.0,621,36039080700
36,039,080700,2,"Block Group 2, Census Tract 807, Greene County, New York",73,232,305,47,16,0,0,0,10,0,232,305,27,9,89,99,8,73,1999.0,2003.0,2013.0,719.0,830.0,986.0,45.6,59208.0,687,36039080700
36,039,080800,1,"Block Group 1, Census Tract 808, Greene County, New York",0,0,0,0,0,0,0,0,0,0,0,0,0,0,0,0,0,0,,,,,,,,,2588,36039080800
36,039,080100,3,"Block Group 3, Census Tract 801, Greene County, New York",12,316,328,12,0,0,0,0,0,0,316,328,132,18,21,115,30,12,1994.0,1997.0,,,,,,99697.0,977,36039080100
36,039,080100,1,"Block Group 1, Census Tract 801, Greene County, New York",37,424,461,13,8,0,8,0,8,13,424,461,58,71,37,110,135,37,2004.0,2005.0,2011.0,388.0,575.0,1063.0,42.5,64115.0,1277,36039080100
36,039,080100,2,"Block Group 2, Census Tract 801, Greene County, New York",0,388,388,0,0,0,0,0,0,8,388,388,101,68,102,67,42,0,1992.0,1992.0,,,,,,77037.0,1025,36039080100
36,105,951500,1,"Block Group 1, Census Tract 9515, Sullivan County, New York",150,119,269,87,48,0,0,0,15,15,119,269,24,24,29,24,3,150,1994.0,2011.0,2013.0,792.0,888.0,1106.0,29.2,50799.0,902,36105951500
36,105,951500,2,"Block Group 2, Census Tract 9515, Sullivan County, New York",309,288,597,74,54,0,16,40,125,22,288,597,23,54,72,94,23,309,1999.0,2004.0,2008.0,561.0,621.0,758.0,27.9,37250.0,1808,36105951500
36,105,950600,3,"Block Group 3, Census Tract 9506, Sullivan County, New York",39,106,145,35,4,0,0,0,0,4,106,145,6,5,37,30,24,39,2002.0,2008.0,2015.0,817.0,852.0,888.0,13.1,45156.0,422,36105950600
36,105,950600,1,"Block Group 1, Census Tract 9506, Sullivan County, New York",53,189,242,22,0,0,7,19,5,0,189,242,37,28,38,69,17,53,1998.0,1999.0,2001.0,628.0,779.0,842.0,17.5,63750.0,668,36105950600
36,105,950600,2,"Block Group 2, Census Tract 9506, Sullivan County, New York",25,198,223,12,0,0,0,0,13,3,198,223,53,31,18,57,36,25,1998.0,2001.0,2010.0,,,,,59464.0,758,36105950600
