STATE,COUNTY,TRACT,BLOCK_GROUP,NAME,B25003_003E,B25003_002E,B25003_001E,B25038_011E,B25038_010E,B25038_015E,B25038_014E,B25038_013E,B25038_012E,B25038_003E,B25038_002E,B25038_001E,B25038_008E,B25038_007E,B25038_006E,B25038_005E,B25038_004E,B25038_009E,B25039_002E,B25039_001E,B25039_003E,B25057_001E,B25058_001E,B25059_001E,B25071_001E,B19013_001E,B01003_001E,GEOID
36,001,014301,1,Block Group 1; Census Tract 143.01; Albany County; New York,22,329,351,7,0,0,0,0,15,0,329,351,102,75,47,105,0,22,1998,2000,-666666666,,,,,84063.0,731,36001014301
36,001,014301,2,Block Group 2; Census Tract 143.01; Albany County; New York,353,591,944,95,40,11,12,35,160,10,591,944,165,62,129,215,10,353,2005,2011,2016,784.0,902.0,978.0,28.7,74459.0,2265,36001014301
36,001,014304,1,Block Group 1; Census Tract 143.04; Albany County; New York,71,127,198,0,0,9,8,49,5,0,127,198,65,16,36,0,10,71,1989,2000,2004,916.0,949.0,982.0,46.7,34597.0,238,36001014304
36,001,014304,2,Block Group 2; Census Tract 143.04; Albany County; New York,462,700,1162,182,29,0,0,0,251,9,700,1162,152,132,180,191,36,462,2004,2012,2017,1602.0,1735.0,1867.0,26.7,102250.0,2853,36001014304
36,001,014401,1,Block Group 1; Census Tract 144.01; Albany County; New York,106,235,341,18,0,0,0,0,88,0,235,341,21,103,32,79,0,106,1999,2011,2015,834.0,916.0,958.0,38.8,93942.0,792,36001014401
36,001,014401,2,Block Group 2; Census Tract 144.01; Albany County; New York,177,738,915,65,0,0,31,0,81,26,738,915,57,158,285,165,47,177,2005,2007,2016,551.0,788.0,874.0,29.3,85221.0,2192,36001014401
36,001,014401,3,Block Group 3; Census Tract 144.01; Albany County; New York,21,430,451,0,0,0,0,0,21,0,430,451,142,61,61,127,39,21,2002,2004,-666666666,764.0,1045.0,1148.0,33.6,110208.0,1010,36001014401
36,001,014402,1,Block Group 1; Census Tract 144.02; Albany County; New York,236,442,678,50,0,0,32,13,141,0,442,678,84,15,186,118,39,236,2007,2010,2014,772.0,880.0,945.0,34.9,66667.0,1547,36001014402
36,001,014402,2,Block Group 2; Census Tract 144.02; Albany County; New York,263,465,728,101,0,0,6,0,156,0,465,728,88,62,120,108,87,263,2007,2013,2016,514.0,905.0,968.0,25.6,69069.0,1712,36001014402
36,001,014803,1,Block Group 1; Census Tract 148.03; Albany County; New York,28,649,677,0,15,0,0,13,0,0,649,677,222,83,142,174,28,28,2001,2002,-666666666,325.0,503.0,562.0,28.2,71838.0,1490,36001014803
36,001,014803,2,Block Group 2; Census Tract 148.03; Albany County; New York,112,408,520,37,11,0,38,0,26,0,408,520,133,41,191,43,0,112,2002,2003,2016,534.0,597.0,880.0,22.0,98977.0,1717,36001014803
36,021,000100,1,Block Group 1; Census Tract 1; Columbia County; New York,41,488,529,5,0,0,8,13,15,0,488,529,92,183,98,69,46,41,1998,1999,2010,554.0,634.0,1027.0,25.8,72446.0,1409,36021000100
36,021,000100,2,Block Group 2; Census Tract 1; Columbia County; New York,112,302,414,40,0,0,0,12,60,0,302,414,60,43,46,75,78,112,2010,2013,2016,693.0,831.0,1052.0,23.9,92813.0,890,36021000100
36,021,000200,1,Block Group 1; Census Tract 2; Columbia County; New York,74,253,327,16,0,9,33,12,4,0,253,327,59,44,78,37,35,74,2003,2002,1998,1287.0,1369.0,1452.0,42.5,120694.0,755,36021000200
36,021,000200,2,Block Group 2; Census Tract 2; Columbia County; New York,55,398,453,19,11,0,0,14,11,4,398,453,130,76,88,68,32,55,1999,2002,2018,776.0,875.0,,27.3,94375.0,906,36021000200
36,021,000300,1,Block Group 1; Census Tract 3; Columbia County; New York,82,266,348,16,5,0,0,26,35,0,266,348,117,59,21,40,29,82,1993,2000,2013,678.0,1194.0,1795.0,35.0,103077.0,769,36021000300
36,021,000300,2,Block Group 2; Census Tract 3; Columbia County; New York,0,320,320,0,0,0,0,0,0,0,320,320,55,91,88,56,30,0,2002,2002,-666666666,,,,,180938.0,773,36021000300
36,021,000300,3,Block Group 3; Census Tract 3; Columbia County; New York,23,289,312,0,0,0,0,0,23,0,289,312,112,33,33,106,5,23,2000,2003,-666666666,1159.0,1315.0,1468.0,23.7,113500.0,615,36021000300
36,021,000300,4,Block Group 4; Census Tract 3; Columbia County; New York,39,376,415,12,0,0,0,19,8,1,376,415,48,144,34,131,18,39,2000,2003,2011,813.0,1263.0,1594.0,27.7,95486.0,956,36021000300
36,021,000300,5,Block Group 5; Census Tract 3; Columbia County; New York,140,252,392,103,0,0,0,4,33,0,252,392,45,40,41,122,4,140,2010,2013,2019,876.0,941.0,990.0,13.4,88750.0,988,36021000300
36,021,000401,1,Block Group 1; Census Tract 4.01; Columbia County; New York,119,650,769,45,0,0,10,6,58,0,650,769,177,69,168,172,64,119,2005,2007,2016,724.0,958.0,1493.0,28.5,77313.0,1588,36021000401
36,021,000401,2,Block Group 2; Census Tract 4.01; Columbia County; New York,66,222,288,17,0,0,0,0,49,0,222,288,28,43,78,54,19,66,2005,2009,2015,713.0,767.0,1542.0,21.7,88716.0,742,36021000401
36,021,000402,1,Block Group 1; Census Tract 4.02; Columbia County; New York,59,617,676,0,0,0,0,16,43,11,617,676,126,109,82,279,10,59,2009,2010,2013,421.0,,1754.0,30.1,109028.0,2177,36021000402
36,021,000402,2,Block Group 2; Census Tract 4.02; Columbia County; New York,117,119,236,0,46,0,0,12,59,0,119,236,30,14,32,18,25,117,2005,2013,2016,775.0,800.0,863.0,33.9,58516.0,500,36021000402
36,021,000402,3,Block Group 3; Census Tract 4.02; Columbia County; New York,150,487,637,23,17,6,0,16,88,10,487,637,61,141,141,90,44,150,2003,2007,2015,563.0,640.0,988.0,32.1,94632.0,1708,36021000402
36,021,000402,4,Block Group 4; Census Tract 4.02; Columbia County; New York,239,489,728,27,22,0,106,27,57,0,489,728,229,55,147,42,16,239,1993,1998,2005,1035.0,1113.0,1191.0,24.2,87232.0,1538,36021000402
36,021,000500,1,Block Group 1; Census Tract 5; Columbia County; New York,142,702,844,7,0,0,4,10,121,2,702,844,218,69,173,204,36,142,2004,2007,2014,940.0,1082.0,1227.0,27.6,73286.0,2195,36021000500
36,021,000600,1,Block Group 1; Census Tract 6; Columbia County; New York,32,344,376,17,0,0,0,4,11,0,344,376,168,35,90,30,21,32,1991,1996,2018,588.0,942.0,1531.0,19.2,104079.0,843,36021000600
36,021,000600,2,Block Group 2; Census Tract 6; Columbia County; New York,123,363,486,36,0,3,0,0,84,0,363,486,71,93,63,97,39,123,2003,2011,2016,1011.0,1097.0,1183.0,16.5,84583.0,1428,36021000600
36,021,000600,3,Block Group 3; Census Tract 6; Columbia County; New York,92,87,179,11,0,18,5,0,58,0,87,179,12,40,17,18,0,92,1998,2009,2013,721.0,748.0,958.0,27.1,59792.0,407,36021000600
36,021,000700,1,Block Group 1; Census Tract 7; Columbia County; New York,56,358,414,0,0,0,0,56,0,57,358,414,82,57,27,114,21,56,2011,2008,-666666666,893.0,1545.0,1772.0,,83333.0,1223,36021000700
36,021,000700,2,Block Group 2; Census Tract 7; Columbia County; New York,97,277,374,0,13,14,4,17,49,0,277,374,19,56,84,118,0,97,2008,2009,2012,481.0,809.0,896.0,36.9,77813.0,1026,36021000700
36,021,000700,3,Block Group 3; Census Tract 7; Columbia County; New York,144,226,370,79,0,0,5,0,60,0,226,370,61,24,24,67,50,144,2010,2014,2018,737.0,921.0,998.0,23.3,106750.0,780,36021000700
36,021,000700,4,Block Group 4; Census Tract 7; Columbia County; New York,49,278,327,0,0,0,0,0,49,0,278,327,44,70,74,80,10,49,2003,2007,-666666666,,,,,109056.0,1016,36021000700
36,021,000700,5,Block Group 5; Census Tract 7; Columbia County; New York,90,353,443,54,0,0,0,0,36,0,353,443,103,108,40,84,18,90,1997,2003,2019,880.0,1083.0,1194.0,26.6,77474.0,1247,36021000700
36,021,000800,1,Block Group 1; Census Tract 8; Columbia County; New York,40,371,411,11,2,0,0,0,27,0,371,411,80,89,65,106,31,40,2003,2006,2016,771.0,815.0,1625.0,45.9,85625.0,885,36021000800
36,021,000800,2,Block Group 2; Census Tract 8; Columbia County; New York,27,331,358,7,0,3,0,3,14,13,331,358,46,109,70,69,24,27,2002,2003,2014,713.0,1031.0,1172.0,21.3,86591.0,781,36021000800
36,021,000900,1,Block Group 1; Census Tract 9; Columbia County; New York,116,279,395,30,32,0,6,17,31,14,279,395,70,51,73,55,16,116,2003,2008,2018,719.0,1025.0,1491.0,29.0,86645.0,873,36021000900
36,021,000900,2,Block Group 2; Census Tract 9; Columbia County; New York,94,338,432,21,0,33,10,0,30,0,338,432,60,135,73,57,13,94,1998,1998,2011,833.0,888.0,990.0,15.8,81667.0,989,36021000900
36,021,001000,1,Block Group 1; Census Tract 10; Columbia County; New York,114,169,283,17,0,0,12,22,63,26,169,283,15,27,78,23,0,114,2005,2009,2013,445.0,618.0,713.0,23.0,57772.0,828,36021001000
36,021,001000,2,Block Group 2; Census Tract 10; Columbia County; New York,180,206,386,66,16,0,0,0,98,0,206,386,49,22,102,14,19,180,2003,2011,2017,,853.0,967.0,17.1,61339.0,1170,36021001000
36,021,001000,3,Block Group 3; Census Tract 10; Columbia County; New York,0,428,428,0,0,0,0,0,0,0,428,428,34,62,149,46,137,0,2008,2008,-666666666,,,,,168000.0,1117,36021001000
36,021,001000,4,Block Group 4; Census Tract 10; Columbia County; New York,84,360,444,0,0,0,0,0,84,0,360,444,150,37,78,81,14,84,1998,2004,-666666666,502.0,524.0,,51.0,77288.0,1129,36021001000
36,021,001000,5,Block Group 5; Census Tract 10; Columbia County; New York,31,331,362,17,0,0,0,0,14,17,331,362,104,75,97,28,10,31,1998,2000,-666666666,,,,,77026.0,997,36021001000
36,021,001000,6,Block Group 6; Census Tract 10; Columbia County; New York,0,359,359,0,0,0,0,0,0,24,359,359,103,31,65,119,17,0,2007,2007,-666666666,,,,,66926.0,808,36021001000
36,021,001100,1,Block Group 1; Census Tract 11; Columbia County; New York,117,171,288,0,14,0,0,0,103,0,171,288,18,51,27,66,9,117,2006,2012,2015,829.0,884.0,1104.0,16.9,86964.0,731,36021001100
36,021,001100,2,Block Group 2; Census Tract 11; Columbia County; New York,58,294,352,0,0,0,0,0,58,14,294,352,25,71,70,102,12,58,2007,2011,-666666666,947.0,993.0,1208.0,51.0,94231.0,881,36021001100
36,021,001100,3,Block Group 3; Census Tract 11; Columbia County; New York,313,464,777,211,0,11,0,8,83,15,464,777,136,47,145,109,12,313,2003,2012,2019,879.0,1206.0,1367.0,42.7,66964.0,1674,36021001100
36,021,001100,4,Block Group 4; Census Tract 11; Columbia County; New York,326,202,528,186,0,0,0,85,55,20,202,528,21,0,59,102,0,326,2012,2015,2018,851.0,1645.0,2217.0,48.6,51815.0,1156,36021001100
36,021,001200,1,Block Group 1; Census Tract 12; Columbia County; New York,221,343,564,97,22,0,0,39,63,11,343,564,64,31,68,140,29,221,2010,2013,2018,1039.0,1185.0,1401.0,29.2,78846.0,1102,36021001200
36,021,001200,2,Block Group 2; Census Tract 12; Columbia County; New York,262,0,262,62,24,0,0,96,80,0,0,262,0,0,0,0,0,262,-666666666,2014,2014,224.0,1089.0,1161.0,51.0,13934.0,389,36021001200
36,021,001200,3,Block Group 3; Census Tract 12; Columbia County; New York,87,129,216,38,0,0,0,21,28,0,129,216,19,43,0,50,17,87,2010,2013,2016,,1055.0,905.0,9.0,53088.0,629,36021001200
36,021,001200,4,Block Group 4; Census Tract 12; Columbia County; New York,156,154,310,14,0,30,0,22,90,14,154,310,0,0,83,27,30,156,2009,2011,2012,715.0,1205.0,1469.0,33.3,50083.0,772,36021001200
36,021,001300,1,Block Group 1; Census Tract 13; Columbia County; New York,347,24,371,0,15,0,0,0,332,0,24,371,0,8,16,0,0,347,-666666666,-666666666,-666666666,614.0,974.0,1299.0,51.0,19436.0,864,36021001300
36,021,001300,2,Block Group 2; Census Tract 13; Columbia County; New York,135,70,205,82,0,0,11,8,34,0,70,205,0,25,4,13,28,135,2014,2018,2019,1009.0,1089.0,1170.0,51.0,54141.0,920,36021001300
36,021,001300,3,Block Group 3; Census Tract 13; Columbia County; New York,112,90,202,42,0,0,0,0,70,20,90,202,0,7,0,27,36,112,2019,2018,2016,1052.0,1198.0,1682.0,38.1,159211.0,286,36021001300
36,021,001300,4,Block Group 4; Census Tract 13; Columbia County; New York,89,144,233,5,0,10,0,11,63,0,144,233,18,16,8,97,5,89,2012,2013,2013,,,1132.0,,80250.0,465,36021001300
36,021,001300,5,Block Group 5; Census Tract 13; Columbia County; New York,133,72,205,64,0,5,10,0,54,0,72,205,17,24,0,23,8,133,1998,2015,2018,1000.0,1696.0,2160.0,23.0,62375.0,496,36021001300
36,021,001400,1,Block Group 1; Census Tract 14; Columbia County; New York,254,420,674,43,0,0,0,0,211,0,420,674,107,100,117,59,37,254,2000,2010,2015,570.0,591.0,644.0,51.0,66518.0,1519,36021001400
36,021,001400,2,Block Group 2; Census Tract 14; Columbia County; New York,177,384,561,0,30,0,10,65,72,10,384,561,72,68,138,68,28,177,2004,2006,2012,818.0,1279.0,1477.0,44.4,59583.0,1387,36021001400
36,021,001400,3,Block Group 3; Census Tract 14; Columbia County; New York,53,236,289,9,0,0,8,12,24,9,236,289,16,27,4,67,113,53,2018,2017,2012,953.0,1066.0,1158.0,29.6,78207.0,724,36021001400
36,021,001500,1,Block Group 1; Census Tract 15; Columbia County; New York,20,221,241,0,0,11,0,6,3,6,221,241,50,41,41,61,22,20,2005,2004,1989,,,,,100375.0,562,36021001500
36,021,001500,2,Block Group 2; Census Tract 15; Columbia County; New York,60,228,288,10,3,0,0,21,26,0,228,288,28,38,64,70,28,60,2008,2009,2013,834.0,893.0,1473.0,23.5,87500.0,693,36021001500
36,021,001600,1,Block Group 1; Census Tract 16; Columbia County; New York,161,348,509,29,0,17,0,0,115,0,348,509,87,39,118,85,19,161,2004,2009,2014,823.0,924.0,1300.0,21.7,109612.0,1537,36021001600
36,021,001600,2,Block Group 2; Census Tract 16; Columbia County; New York,35,363,398,0,0,0,14,0,21,16,363,398,21,130,116,61,19,35,2003,2003,-666666666,1030.0,1121.0,1211.0,17.4,121765.0,735,36021001600
36,021,001600,3,Block Group 3; Census Tract 16; Columbia County; New York,88,207,295,0,0,0,11,40,37,7,207,295,39,13,79,20,49,88,2007,2007,2008,838.0,908.0,954.0,29.5,42554.0,547,36021001600
36,021,001600,4,Block Group 4; Census Tract 16; Columbia County; New York,0,222,222,0,0,0,0,0,0,20,222,222,23,0,66,102,11,0,2012,2012,-666666666,,,,,125403.0,534,36021001600
36,021,001700,1,Block Group 1; Census Tract 17; Columbia County; New York,43,245,288,0,0,0,3,6,34,10,245,288,38,44,56,73,24,43,2007,2010,2013,368.0,964.0,1063.0,23.1,81875.0,834,36021001700
36,021,001700,2,Block Group 2; Census Tract 17; Columbia County; New York,25,222,247,0,4,3,0,0,18,2,222,247,76,37,37,48,22,25,1999,2002,2014,842.0,904.0,952.0,33.5,89135.0,606,36021001700
36,021,001800,1,Block Group 1; Census Tract 18; Columbia County; New York,7,158,165,3,0,0,0,0,4,4,158,165,47,51,37,13,6,7,1996,1997,-666666666,764.0,778.0,,12.8,113375.0,380,36021001800
36,021,001800,2,Block Group 2; Census Tract 18; Columbia County; New York,39,390,429,9,0,0,5,7,18,0,390,429,52,103,129,87,19,39,2003,2004,2013,528.0,625.0,1078.0,17.9,85089.0,1128,36021001800
36,021,001900,1,Block Group 1; Census Tract 19; Columbia County; New York,69,356,425,19,0,0,0,0,50,0,356,425,53,61,126,89,27,69,2005,2008,2016,710.0,1080.0,1546.0,37.5,83875.0,1177,36021001900
36,021,001900,2,Block Group 2; Census Tract 19; Columbia County; New York,64,308,372,26,6,0,21,0,11,0,308,372,41,32,133,67,35,64,2006,2007,2018,860.0,920.0,980.0,51.0,110357.0,926,36021001900
36,021,002000,1,Block Group 1; Census Tract 20; Columbia County; New York,48,271,319,2,9,0,0,0,37,0,271,319,103,32,60,35,41,48,2000,2004,2015,750.0,1075.0,2111.0,28.5,89750.0,619,36021002000
36,021,002000,2,Block Group 2; Census Tract 20; Columbia County; New York,106,444,550,41,11,0,0,0,54,16,444,550,102,50,141,101,34,106,2005,2009,2018,344.0,490.0,1475.0,27.4,90372.0,1140,36021002000
36,025,971400,1,Block Group 1; Census Tract 9714; Delaware County; New York,48,434,482,20,0,0,0,0,28,8,434,482,90,89,87,81,79,48,2004,2007,2017,727.0,930.0,1346.0,51.0,90052.0,1008,36025971400
36,025,971400,2,Block Group 2; Census Tract 9714; Delaware County; New York,87,219,306,9,29,0,0,40,9,0,219,306,22,43,55,93,6,87,2008,2009,2013,,,,,60000.0,669,36025971400
36,025,971400,3,Block Group 3; Census Tract 9714; Delaware County; New York,95,158,253,28,4,0,26,3,34,3,158,253,63,27,35,11,19,95,1996,2003,2014,635.0,698.0,745.0,31.0,50417.0,526,36025971400
36,025,971400,4,Block Group 4; Census Tract 9714; Delaware County; New York,76,209,285,23,9,0,0,0,44,7,209,285,110,26,35,15,16,76,1989,2002,2017,338.0,585.0,693.0,51.0,24089.0,582,36025971400
36,027,010000,1,Block Group 1; Census Tract 100; Dutchess County; New York,219,105,324,85,0,0,0,36,98,0,105,324,15,14,13,21,42,219,2014,2016,2016,726.0,1038.0,1144.0,21.5,75956.0,823,36027010000
36,027,010000,2,Block Group 2; Census Tract 100; Dutchess County; New York,116,265,381,40,0,0,0,45,31,7,265,381,36,48,106,41,27,116,2005,2007,2013,548.0,922.0,1152.0,28.6,78542.0,1189,36027010000
36,027,010000,3,Block Group 3; Census Tract 100; Dutchess County; New York,188,286,474,49,0,11,0,24,104,0,286,474,146,53,51,36,0,188,1989,2004,2015,985.0,1192.0,1385.0,28.9,72091.0,1053,36027010000
36,027,010000,4,Block Group 4; Census Tract 100; Dutchess County; New York,82,198,280,42,0,0,0,26,14,0,198,280,32,62,38,58,8,82,2001,2007,2018,489.0,660.0,690.0,34.9,65000.0,765,36027010000
36,027,020003,1,Block Group 1; Census Tract 200.03; Dutchess County; New York,74,233,307,0,0,0,0,0,74,16,233,307,5,47,71,68,26,74,2009,2012,-666666666,2071.0,2214.0,2357.0,38.5,81506.0,849,36027020003
36,027,020003,2,Block Group 2; Census Tract 200.03; Dutchess County; New York,62,296,358,38,0,0,0,0,24,14,296,358,44,69,68,70,31,62,2005,2010,2019,1010.0,1112.0,1214.0,51.0,98750.0,950,36027020003
36,027,020003,3,Block Group 3; Census Tract 200.03; Dutchess County; New York,0,397,397,0,0,0,0,0,0,0,397,397,66,59,73,169,30,0,2010,2010,-666666666,,,,,114020.0,1502,36027020003
36,027,020003,4,Block Group 4; Census Tract 200.03; Dutchess County; New York,0,458,458,0,0,0,0,0,0,0,458,458,66,104,132,100,56,0,2004,2004,-666666666,,,,,138438.0,1315,36027020003
36,027,020004,1,Block Group 1; Census Tract 200.04; Dutchess County; New York,35,85,120,5,0,0,13,0,17,0,85,120,5,11,31,24,14,35,2009,2010,2012,958.0,1559.0,1779.0,28.8,133182.0,298,36027020004
36,027,020004,2,Block Group 2; Census Tract 200.04; Dutchess County; New York,0,435,435,0,0,0,0,0,0,0,435,435,134,84,113,104,0,0,2000,2000,-666666666,,,,,121477.0,1222,36027020004
36,027,020004,3,Block Group 3; Census Tract 200.04; Dutchess County; New York,36,308,344,0,0,12,0,0,24,0,308,344,62,93,69,48,36,36,2000,2001,-666666666,892.0,1078.0,1164.0,24.2,130625.0,1173,36027020004
36,027,020005,1,Block Group 1; Census Tract 200.05; Dutchess County; New York,73,518,591,51,12,0,0,10,0,0,518,591,186,43,174,56,59,73,2002,2004,2020,1075.0,1150.0,1224.0,51.0,95764.0,1836,36027020005
36,027,020005,2,Block Group 2; Census Tract 200.05; Dutchess County; New York,94,252,346,0,0,0,0,69,25,8,252,346,53,40,30,102,19,94,2010,2008,-666666666,,,,,107738.0,1041,36027020005
36,027,020005,3,Block Group 3; Census Tract 200.05; Dutchess County; New York,69,256,325,0,0,0,0,0,69,0,256,325,91,36,52,37,40,69,2000,2007,-666666666,1299.0,1416.0,1625.0,19.0,127634.0,891,36027020005
36,027,020005,4,Block Group 4; Census Tract 200.05; Dutchess County; New York,0,441,441,0,0,0,0,0,0,6,441,441,13,47,199,121,55,0,2008,2008,-666666666,,,,,183750.0,1317,36027020005
36,027,030000,1,Block Group 1; Census Tract 300; Dutchess County; New York,19,370,389,0,0,8,0,11,0,39,370,389,79,92,68,57,35,19,2002,2002,2001,,,,,136250.0,851,36027030000
36,027,030000,2,Block Group 2; Census Tract 300; Dutchess County; New York,0,421,421,0,0,0,0,0,0,0,421,421,153,79,105,32,52,0,1997,1997,-666666666,,,,,77542.0,1191,36027030000
36,027,030000,3,Block Group 3; Census Tract 300; Dutchess County; New York,0,344,344,0,0,0,0,0,0,30,344,344,128,43,42,30,71,0,2000,2000,-666666666,,,,,140250.0,985,36027030000
36,027,030000,4,Block Group 4; Census Tract 300; Dutchess County; New York,13,396,409,0,0,0,9,0,4,0,396,409,123,75,133,21,44,13,2000,2000,-666666666,,,,,94659.0,1038,36027030000
36,027,040001,1,Block Group 1; Census Tract 400.01; Dutchess County; New York,21,181,202,0,0,0,0,0,21,12,181,202,10,21,59,54,25,21,2010,2011,-666666666,,,,,71689.0,803,36027040001
36,027,040001,2,Block Group 2; Census Tract 400.01; Dutchess County; New York,232,729,961,27,0,0,36,91,78,58,729,961,205,286,130,25,25,232,1996,1999,2009,926.0,962.0,2078.0,51.0,142132.0,2522,36027040001
36,027,040001,3,Block Group 3; Census Tract 400.01; Dutchess County; New York,64,276,340,16,0,0,17,4,27,0,276,340,82,31,56,107,0,64,2004,2007,2013,,737.0,1050.0,51.0,136071.0,689,36027040001
36,027,040001,4,Block Group 4; Census Tract 400.01; Dutchess County; New York,159,152,311,100,0,0,0,0,59,0,152,311,0,49,42,51,10,159,2006,2015,2019,628.0,895.0,1316.0,24.4,44964.0,720,36027040001
36,027,040003,1,Block Group 1; Census Tract 400.03; Dutchess County; New York,321,424,745,106,0,0,161,10,44,11,424,745,52,69,205,61,26,321,2004,2004,2000,864.0,950.0,1358.0,19.5,91615.0,1588,36027040003
36,027,040003,2,Block Group 2; Census Tract 400.03; Dutchess County; New York,119,392,511,64,0,0,0,26,29,53,392,511,36,59,87,138,19,119,2011,2012,2018,834.0,981.0,1662.0,35.1,74904.0,1314,36027040003
36,027,040003,3,Block Group 3; Census Tract 400.03; Dutchess County; New York,0,267,267,0,0,0,0,0,0,0,267,267,0,48,33,178,8,0,2012,2012,-666666666,,1077.0,1163.0,36.0,114550.0,765,36027040003
36,027,050102,1,Block Group 1; Census Tract 501.02; Dutchess County; New York,101,409,510,0,0,0,92,0,9,16,409,510,80,51,14,188,60,101,2013,2011,-666666666,,,,,176071.0,1420,36027050102
36,027,050102,2,Block Group 2; Census Tract 501.02; Dutchess County; New York,89,750,839,0,0,0,7,0,82,9,750,839,200,102,168,214,57,89,2004,2007,2014,1664.0,1829.0,1993.0,51.0,107208.0,2387,36027050102
36,027,050103,1,Block Group 1; Census Tract 501.03; Dutchess County; New York,0,126,126,0,0,0,0,0,0,0,126,126,22,63,12,29,0,0,1997,1997,-666666666,,,,,164286.0,463,36027050103
36,027,050103,2,Block Group 2; Census Tract 501.03; Dutchess County; New York,0,604,604,0,0,0,0,0,0,0,604,604,105,120,168,177,34,0,2005,2005,-666666666,,,,,106071.0,1602,36027050103
36,027,050103,3,Block Group 3; Census Tract 501.03; Dutchess County; New York,6,333,339,6,0,0,0,0,0,0,333,339,25,112,66,125,5,6,2004,2005,-666666666,,,,,163906.0,1404,36027050103
36,027,050103,4,Block Group 4; Census Tract 501.03; Dutchess County; New York,0,408,408,0,0,0,0,0,0,0,408,408,55,80,118,104,51,0,2006,2006,-666666666,,,,,103929.0,1354,36027050103
36,027,050103,5,Block Group 5; Census Tract 501.03; Dutchess County; New York,0,427,427,0,0,0,0,0,0,0,427,427,129,87,73,55,83,0,2000,2000,-666666666,,,,,133672.0,1086,36027050103
36,027,050104,1,Block Group 1; Census Tract 501.04; Dutchess County; New York,0,226,226,0,0,0,0,0,0,0,226,226,34,51,42,83,16,0,2007,2007,-666666666,,,,,165071.0,706,36027050104
36,027,050104,2,Block Group 2; Census Tract 501.04; Dutchess County; New York,20,283,303,0,0,20,0,0,0,0,283,303,33,127,96,13,14,20,1999,1998,-666666666,,,,,104963.0,779,36027050104
36,027,050104,3,Block Group 3; Census Tract 501.04; Dutchess County; New York,103,616,719,0,23,0,0,0,80,22,616,719,11,48,214,262,59,103,2011,2012,-666666666,,,,,144766.0,2403,36027050104
36,027,050104,4,Block Group 4; Census Tract 501.04; Dutchess County; New York,16,358,374,0,0,0,0,0,16,0,358,374,12,42,177,105,22,16,2007,2008,-666666666,,,,,250001.0,1658,36027050104
36,027,050104,5,Block Group 5; Census Tract 501.04; Dutchess County; New York,0,258,258,0,0,0,0,0,0,0,258,258,29,34,110,15,70,0,2006,2006,-666666666,,,,,119524.0,668,36027050104
36,027,050203,1,Block Group 1; Census Tract 502.03; Dutchess County; New York,10,323,333,0,0,10,0,0,0,18,323,333,83,14,35,126,47,10,2012,2012,-666666666,,,,,134297.0,1036,36027050203
36,027,050203,2,Block Group 2; Census Tract 502.03; Dutchess County; New York,83,429,512,7,0,19,0,0,57,4,429,512,69,50,129,153,24,83,2007,2009,2013,1006.0,1087.0,1169.0,51.0,101818.0,1564,36027050203
36,027,050203,3,Block Group 3; Census Tract 502.03; Dutchess County; New York,101,425,526,25,28,6,0,0,42,0,425,526,135,46,111,120,13,101,2003,2007,2018,1107.0,1214.0,1400.0,24.7,99539.0,1507,36027050203
36,027,050203,4,Block Group 4; Census Tract 502.03; Dutchess County; New York,23,339,362,23,0,0,0,0,0,0,339,362,75,86,112,57,9,23,2001,2002,-666666666,,,,,167778.0,1215,36027050203
36,027,050204,1,Block Group 1; Census Tract 502.04; Dutchess County; New York,0,574,574,0,0,0,0,0,0,0,574,574,60,61,192,114,147,0,2009,2009,-666666666,,,,,164943.0,1725,36027050204
36,027,050204,2,Block Group 2; Census Tract 502.04; Dutchess County; New York,61,300,361,3,0,4,6,0,48,12,300,361,67,59,46,106,10,61,2005,2010,2013,917.0,1263.0,1400.0,19.7,122232.0,1097,36027050204
36,027,050205,1,Block Group 1; Census Tract 502.05; Dutchess County; New York,47,746,793,0,0,0,0,0,47,0,746,793,19,194,281,183,69,47,2006,2007,-666666666,,,,,112125.0,2682,36027050205
36,027,050205,2,Block Group 2; Census Tract 502.05; Dutchess County; New York,41,235,276,31,0,0,0,0,10,0,235,276,40,94,55,25,21,41,1998,2001,-666666666,,,,,135069.0,725,36027050205
36,027,050205,3,Block Group 3; Census Tract 502.05; Dutchess County; New York,11,509,520,0,0,0,0,0,11,24,509,520,118,21,201,112,33,11,2006,2006,-666666666,,,,,115000.0,1378,36027050205
36,027,050205,4,Block Group 4; Census Tract 502.05; Dutchess County; New York,19,289,308,10,0,0,0,0,9,0,289,308,57,77,99,54,2,19,2001,2002,-666666666,,,,,185093.0,868,36027050205
36,027,060100,1,Block Group 1; Census Tract 601; Dutchess County; New York,641,286,927,344,12,14,0,23,248,10,286,927,22,0,45,143,66,641,2014,2017,2018,1334.0,1475.0,1783.0,28.5,61676.0,1384,36027060100
36,027,060100,2,Block Group 2; Census Tract 601; Dutchess County; New York,51,345,396,51,0,0,0,0,0,17,345,396,93,112,123,0,0,51,1997,1999,-666666666,,,,,204794.0,1221,36027060100
36,027,060100,3,Block Group 3; Census Tract 601; Dutchess County; New York,153,7,160,8,0,0,0,4,141,0,7,160,7,0,0,0,0,153,-666666666,2014,2014,1047.0,1114.0,1182.0,29.1,53059.0,290,36027060100
36,027,060100,4,Block Group 4; Census Tract 601; Dutchess County; New York,382,368,750,58,114,0,0,25,185,9,368,750,7,0,138,175,39,382,2012,2015,2017,1786.0,2257.0,2717.0,26.9,111310.0,1931,36027060100
36,027,060100,5,Block Group 5; Census Tract 601; Dutchess County; New York,0,0,0,0,0,0,0,0,0,0,0,0,0,0,0,0,0,0,-666666666,-666666666,-666666666,,,,,,884,36027060100
36,027,060201,1,Block Group 1; Census Tract 602.01; Dutchess County; New York,223,259,482,153,13,0,0,23,34,0,259,482,70,32,96,43,18,223,2003,2012,2019,1157.0,1310.0,,39.9,77266.0,975,36027060201
36,027,060201,2,Block Group 2; Census Tract 602.01; Dutchess County; New York,80,577,657,36,0,0,0,16,28,15,577,657,128,92,31,234,77,80,2011,2012,2017,1042.0,2025.0,2214.0,34.3,120458.0,1508,36027060201
36,027,060201,3,Block Group 3; Census Tract 602.01; Dutchess County; New York,145,386,531,42,0,0,0,0,103,28,386,531,79,80,56,86,57,145,2006,2012,2016,1465.0,1681.0,1882.0,17.7,111910.0,1141,36027060201
36,027,060202,1,Block Group 1; Census Tract 602.02; Dutchess County; New York,586,243,829,274,39,7,64,53,149,0,243,829,66,71,91,15,0,586,1998,2013,2018,882.0,1450.0,1769.0,32.0,68098.0,1689,36027060202
36,027,060202,2,Block Group 2; Census Tract 602.02; Dutchess County; New York,177,545,722,23,54,30,16,34,20,0,545,722,126,56,141,168,54,177,2006,2008,2013,875.0,1159.0,1654.0,49.6,63902.0,1548,36027060202
36,027,060202,3,Block Group 3; Census Tract 602.02; Dutchess County; New York,51,380,431,41,0,0,0,0,10,0,380,431,38,13,119,194,16,51,2011,2012,2019,1106.0,1213.0,1348.0,31.1,91696.0,901,36027060202
36,027,060202,4,Block Group 4; Census Tract 602.02; Dutchess County; New York,0,166,166,0,0,0,0,0,0,14,166,166,21,33,59,12,27,0,2005,2005,-666666666,,,,,132821.0,422,36027060202
36,027,060301,1,Block Group 1; Census Tract 603.01; Dutchess County; New York,5,435,440,5,0,0,0,0,0,0,435,440,40,65,164,136,30,5,2007,2007,-666666666,,,,,151667.0,1611,36027060301
36,027,060301,2,Block Group 2; Census Tract 603.01; Dutchess County; New York,46,262,308,12,0,0,0,0,34,0,262,308,83,9,97,41,32,46,2004,2006,-666666666,,,,,92083.0,809,36027060301
36,027,060301,3,Block Group 3; Census Tract 603.01; Dutchess County; New York,52,330,382,0,0,0,0,0,52,0,330,382,160,0,110,35,25,52,2000,2003,-666666666,,,,,81726.0,934,36027060301
36,027,060301,4,Block Group 4; Census Tract 603.01; Dutchess County; New York,160,346,506,43,40,0,8,0,69,36,346,506,79,61,81,42,47,160,2004,2012,2018,1145.0,1304.0,1750.0,29.3,101181.0,848,36027060301
36,027,060302,1,Block Group 1; Census Tract 603.02; Dutchess County; New York,228,883,1111,66,27,0,0,78,57,47,883,1111,9,0,410,370,47,228,2010,2011,2015,1268.0,1408.0,3501.0,42.3,89769.0,2433,36027060302
36,027,060400,1,Block Group 1; Census Tract 604; Dutchess County; New York,257,136,393,68,6,9,39,4,131,0,136,393,11,13,71,0,41,257,2006,2013,2015,1254.0,1372.0,1490.0,34.4,83542.0,703,36027060400
36,027,060400,2,Block Group 2; Census Tract 604; Dutchess County; New York,489,266,755,187,58,0,6,0,238,6,266,755,37,19,126,53,25,489,2006,2015,2018,1860.0,2182.0,2405.0,31.8,97279.0,1474,36027060400
36,027,070101,1,Block Group 1; Census Tract 701.01; Dutchess County; New York,114,171,285,41,12,0,0,32,29,0,171,285,12,12,42,68,37,114,2012,2014,2017,953.0,1117.0,1664.0,33.9,75521.0,798,36027070101
36,027,070101,2,Block Group 2; Census Tract 701.01; Dutchess County; New York,217,418,635,66,42,0,0,0,109,15,418,635,120,39,117,99,28,217,2004,2012,2018,1050.0,1140.0,1230.0,51.0,74896.0,1345,36027070101
36,027,070101,3,Block Group 3; Census Tract 701.01; Dutchess County; New York,87,744,831,13,0,7,0,12,55,56,744,831,140,72,148,248,80,87,2010,2011,2014,704.0,724.0,744.0,18.0,142821.0,2110,36027070101
36,027,070102,1,Block Group 1; Census Tract 701.02; Dutchess County; New York,21,158,179,0,0,0,0,0,21,0,158,179,16,22,61,27,32,21,2007,2008,-666666666,,,,,111250.0,367,36027070102
36,027,070102,2,Block Group 2; Census Tract 701.02; Dutchess County; New York,235,491,726,100,0,0,54,44,37,10,491,726,104,95,92,155,35,235,2005,2008,2014,1133.0,1327.0,1445.0,36.6,85079.0,1981,36027070102
36,027,070102,3,Block Group 3; Census Tract 701.02; Dutchess County; New York,59,423,482,18,0,0,16,0,25,0,423,482,113,126,41,123,20,59,1998,1999,2014,1205.0,1730.0,2039.0,26.4,102813.0,1304,36027070102
36,027,070201,1,Block Group 1; Census Tract 702.01; Dutchess County; New York,181,526,707,68,44,0,11,37,21,14,526,707,167,54,117,120,54,181,2004,2008,2019,655.0,937.0,1108.0,51.0,105363.0,1610,36027070201
36,027,070201,2,Block Group 2; Census Tract 702.01; Dutchess County; New York,288,126,414,59,0,0,0,88,141,0,126,414,53,0,26,47,0,288,2004,2012,2013,729.0,981.0,1378.0,51.0,27188.0,630,36027070201
36,027,070201,3,Block Group 3; Census Tract 702.01; Dutchess County; New York,176,95,271,8,0,0,27,62,79,14,95,271,0,9,9,52,11,176,2015,2012,2010,783.0,1074.0,1215.0,37.9,57731.0,517,36027070201
36,027,070301,1,Block Group 1; Census Tract 703.01; Dutchess County; New York,71,490,561,0,0,0,0,71,0,31,490,561,88,226,78,41,26,71,1997,1999,-666666666,,,,,112389.0,1637,36027070301
36,027,070301,2,Block Group 2; Census Tract 703.01; Dutchess County; New York,100,432,532,0,0,0,0,0,100,0,432,532,108,32,90,138,64,100,2008,2011,-666666666,1083.0,1302.0,1401.0,28.6,75909.0,1418,36027070301
36,027,070301,3,Block Group 3; Census Tract 703.01; Dutchess County; New York,51,493,544,0,0,0,0,0,51,0,493,544,169,74,118,121,11,51,2000,2002,-666666666,,,,,104071.0,1397,36027070301
36,027,070301,4,Block Group 4; Census Tract 703.01; Dutchess County; New York,504,314,818,220,0,10,19,14,241,0,314,818,102,79,80,53,0,504,1997,2013,2017,844.0,914.0,988.0,22.8,73036.0,1436,36027070301
36,027,070401,1,Block Group 1; Census Tract 704.01; Dutchess County; New York,42,256,298,9,0,0,0,0,33,14,256,298,50,65,65,54,8,42,2002,2005,-666666666,829.0,857.0,886.0,22.9,94076.0,922,36027070401
36,027,070401,2,Block Group 2; Census Tract 704.01; Dutchess County; New York,141,681,822,62,10,0,9,0,60,0,681,822,135,63,229,204,50,141,2006,2009,2018,880.0,1258.0,1441.0,42.1,85714.0,3710,36027070401
36,027,080103,1,Block Group 1; Census Tract 801.03; Dutchess County; New York,138,392,530,13,0,85,0,9,31,0,392,530,148,67,63,75,39,138,1997,1995,1989,319.0,,,21.5,78846.0,1357,36027080103
36,027,080103,2,Block Group 2; Census Tract 801.03; Dutchess County; New York,29,637,666,0,0,0,0,0,29,0,637,666,99,128,126,229,55,29,2007,2008,-666666666,1353.0,1456.0,2183.0,26.7,160976.0,2345,36027080103
36,027,080103,3,Block Group 3; Census Tract 801.03; Dutchess County; New York,0,375,375,0,0,0,0,0,0,0,375,375,79,103,44,101,48,0,2001,2001,-666666666,,,,,128281.0,1017,36027080103
36,027,080104,1,Block Group 1; Census Tract 801.04; Dutchess County; New York,192,420,612,132,8,0,10,0,42,14,420,612,63,95,128,102,18,192,2004,2011,2019,1900.0,2147.0,2324.0,33.4,104662.0,1640,36027080104
36,027,080104,2,Block Group 2; Census Tract 801.04; Dutchess County; New York,27,367,394,11,0,0,0,16,0,11,367,394,123,66,87,38,42,27,1999,2001,-666666666,1355.0,1461.0,1693.0,51.0,88942.0,968,36027080104
36,027,080104,3,Block Group 3; Census Tract 801.04; Dutchess County; New York,71,379,450,12,0,0,0,0,59,0,379,450,55,187,66,31,40,71,1997,1999,2015,1091.0,,2177.0,37.4,131658.0,1655,36027080104
36,027,080201,1,Block Group 1; Census Tract 802.01; Dutchess County; New York,47,579,626,0,8,0,0,11,28,14,579,626,118,149,91,164,43,47,2002,2005,2014,962.0,1580.0,1790.0,22.0,131574.0,1602,36027080201
36,027,080201,2,Block Group 2; Census Tract 802.01; Dutchess County; New York,17,316,333,0,0,0,0,0,17,0,316,333,99,75,105,11,26,17,1998,1999,-666666666,,,,,109491.0,698,36027080201
36,027,080201,3,Block Group 3; Census Tract 802.01; Dutchess County; New York,0,178,178,0,0,0,0,0,0,0,178,178,38,18,57,19,46,0,2006,2006,-666666666,,,,,129444.0,541,36027080201
36,027,080201,4,Block Group 4; Census Tract 802.01; Dutchess County; New York,17,505,522,0,0,0,0,0,17,0,505,522,172,28,76,193,36,17,2007,2008,-666666666,,,,,135536.0,1409,36027080201
36,027,080202,1,Block Group 1; Census Tract 802.02; Dutchess County; New York,63,198,261,0,0,0,0,0,63,10,198,261,45,20,54,29,40,63,2006,2011,-666666666,940.0,981.0,1086.0,46.9,114464.0,665,36027080202
36,027,080202,2,Block Group 2; Census Tract 802.02; Dutchess County; New York,66,352,418,42,0,0,0,0,24,3,352,418,22,53,81,152,41,66,2011,2012,2019,930.0,979.0,1342.0,14.9,82772.0,1121,36027080202
36,027,080202,3,Block Group 3; Census Tract 802.02; Dutchess County; New York,10,357,367,0,0,0,0,0,10,41,357,367,42,55,114,22,83,10,2007,2008,-666666666,,,,,158958.0,1117,36027080202
36,027,090000,1,Block Group 1; Census Tract 900; Dutchess County; New York,154,311,465,81,15,13,0,11,34,21,311,465,66,63,70,72,19,154,2004,2011,2019,1079.0,1168.0,1300.0,26.8,77344.0,1008,36027090000
36,027,090000,2,Block Group 2; Census Tract 900; Dutchess County; New York,81,575,656,42,0,10,11,5,13,7,575,656,114,102,116,189,47,81,2006,2008,2018,900.0,1339.0,1492.0,36.6,96364.0,1419,36027090000
36,027,100000,1,Block Group 1; Census Tract 1000; Dutchess County; New York,91,425,516,23,28,0,0,0,40,44,425,516,112,122,95,52,0,91,1998,2003,2019,,2140.0,2320.0,51.0,102206.0,1157,36027100000
36,027,100000,2,Block Group 2; Census Tract 1000; Dutchess County; New York,46,393,439,11,10,0,0,0,25,24,393,439,72,125,35,94,43,46,2000,2006,2017,795.0,947.0,1250.0,51.0,93000.0,956,36027100000
36,027,100000,3,Block Group 3; Census Tract 1000; Dutchess County; New York,149,173,322,24,7,0,10,9,99,2,173,322,59,4,63,34,11,149,2004,2011,2014,785.0,995.0,1313.0,18.5,78953.0,862,36027100000
36,027,110003,1,Block Group 1; Census Tract 1100.03; Dutchess County; New York,29,723,752,9,0,0,0,20,0,0,723,752,70,100,228,302,23,29,2008,2008,-666666666,,,,,143869.0,2522,36027110003
36,027,110003,2,Block Group 2; Census Tract 1100.03; Dutchess County; New York,46,288,334,35,0,0,0,0,11,0,288,334,162,58,47,21,0,46,1989,1991,-666666666,1125.0,1625.0,2250.0,33.8,95682.0,601,36027110003
36,027,110003,3,Block Group 3; Census Tract 1100.03; Dutchess County; New York,12,302,314,0,0,0,0,0,12,0,302,314,49,86,64,64,39,12,2003,2003,-666666666,,,,,191667.0,909,36027110003
36,027,120000,1,Block Group 1; Census Tract 1200; Dutchess County; New York,94,415,509,27,0,0,4,13,50,7,415,509,144,31,140,52,41,94,2002,2005,2015,831.0,1321.0,1544.0,28.8,69701.0,1226,36027120000
36,027,120000,2,Block Group 2; Census Tract 1200; Dutchess County; New York,106,261,367,2,19,0,0,13,72,6,261,367,55,64,66,39,31,106,2002,2008,2014,808.0,1250.0,1653.0,29.1,98063.0,852,36027120000
36,027,130003,1,Block Group 1; Census Tract 1300.03; Dutchess County; New York,98,375,473,0,0,0,16,36,46,0,375,473,102,110,69,38,56,98,1998,2001,2009,1375.0,1500.0,1750.0,42.5,87326.0,1031,36027130003
36,027,130003,2,Block Group 2; Census Tract 1300.03; Dutchess County; New York,66,612,678,58,0,0,0,0,8,0,612,678,164,155,171,56,66,66,1999,2001,2019,1084.0,1168.0,1193.0,40.9,126250.0,1862,36027130003
36,027,130003,3,Block Group 3; Census Tract 1300.03; Dutchess County; New York,888,211,1099,356,23,0,7,272,230,0,211,1099,42,0,14,133,22,888,2013,2015,2016,1159.0,1672.0,2137.0,28.2,88015.0,2356,36027130003
36,027,130004,1,Block Group 1; Census Tract 1300.04; Dutchess County; New York,29,222,251,7,0,0,0,7,15,12,222,251,86,14,38,60,12,29,2003,2006,2014,804.0,1025.0,1479.0,16.6,141641.0,641,36027130004
36,027,130004,2,Block Group 2; Census Tract 1300.04; Dutchess County; New York,32,367,399,7,0,6,0,0,19,9,367,399,99,42,133,65,19,32,2003,2004,2014,543.0,,1323.0,12.9,145994.0,1143,36027130004
36,027,130005,1,Block Group 1; Census Tract 1300.05; Dutchess County; New York,97,519,616,97,0,0,0,0,0,0,519,616,33,106,104,187,89,97,2011,2013,-666666666,1229.0,1766.0,2711.0,31.0,102045.0,1596,36027130005
36,027,130005,2,Block Group 2; Census Tract 1300.05; Dutchess County; New York,30,452,482,0,0,0,0,9,21,30,452,482,108,63,143,70,38,30,2004,2005,-666666666,688.0,837.0,889.0,40.8,91974.0,1166,36027130005
36,027,140101,1,Block Group 1; Census Tract 1401.01; Dutchess County; New York,111,346,457,70,41,0,0,0,0,0,346,457,22,84,43,84,113,111,2012,2018,2020,784.0,1313.0,1432.0,19.0,91740.0,1389,36027140101
36,027,140101,2,Block Group 2; Census Tract 1401.01; Dutchess County; New York,66,196,262,56,0,0,10,0,0,0,196,262,11,46,78,15,46,66,2005,2008,2019,946.0,1054.0,1152.0,51.0,85395.0,844,36027140101
36,027,140101,3,Block Group 3; Census Tract 1401.01; Dutchess County; New York,240,173,413,23,20,0,0,0,197,9,173,413,65,24,19,31,25,240,1999,2013,2015,1088.0,1218.0,1411.0,27.5,75563.0,1405,36027140101
36,027,140101,4,Block Group 4; Census Tract 1401.01; Dutchess County; New York,207,259,466,121,0,0,66,0,20,0,259,466,42,52,116,21,28,207,2003,2006,2018,1106.0,1256.0,1480.0,26.1,100455.0,1497,36027140101
36,027,140101,5,Block Group 5; Census Tract 1401.01; Dutchess County; New York,0,0,0,0,0,0,0,0,0,0,0,0,0,0,0,0,0,0,-666666666,-666666666,-666666666,,,,,,2002,36027140101
36,027,140201,1,Block Group 1; Census Tract 1402.01; Dutchess County; New York,35,296,331,30,0,0,0,5,0,31,296,331,25,111,67,49,13,35,2002,2004,-666666666,,,2226.0,26.7,116875.0,904,36027140201
36,027,140201,2,Block Group 2; Census Tract 1402.01; Dutchess County; New York,327,402,729,16,0,0,244,25,42,26,402,729,59,76,100,127,14,327,2007,2000,1997,1129.0,2101.0,2301.0,51.0,49229.0,1539,36027140201
36,027,140202,1,Block Group 1; Census Tract 1402.02; Dutchess County; New York,39,569,608,0,0,0,0,0,39,0,569,608,139,104,24,210,92,39,2011,2011,-666666666,,,,,134167.0,2053,36027140202
36,027,140202,2,Block Group 2; Census Tract 1402.02; Dutchess County; New York,556,263,819,242,82,0,13,41,178,0,263,819,24,0,113,88,38,556,2010,2017,2019,1189.0,1358.0,1475.0,32.9,56250.0,1668,36027140202
36,027,140202,3,Block Group 3; Census Tract 1402.02; Dutchess County; New York,154,415,569,0,0,0,0,32,122,14,415,569,80,0,68,106,147,154,2014,2014,2013,1493.0,2006.0,2253.0,24.5,91010.0,1171,36027140202
36,027,140301,1,Block Group 1; Census Tract 1403.01; Dutchess County; New York,22,311,333,0,0,0,0,0,22,0,311,333,181,13,48,0,69,22,1989,1989,-666666666,,,,,53141.0,808,36027140301
36,027,140301,2,Block Group 2; Census Tract 1403.01; Dutchess County; New York,227,186,413,139,0,19,0,27,42,0,186,413,32,0,132,22,0,227,2005,2010,2019,1490.0,1664.0,1832.0,39.3,62628.0,676,36027140301
36,027,140301,3,Block Group 3; Census Tract 1403.01; Dutchess County; New York,835,225,1060,341,73,0,0,245,176,0,225,1060,5,11,126,61,22,835,2008,2015,2018,,1401.0,1710.0,41.7,51071.0,1610,36027140301
36,027,140302,1,Block Group 1; Census Tract 1403.02; Dutchess County; New York,97,180,277,0,0,0,0,37,60,0,180,277,0,42,20,118,0,97,2012,2012,2012,,1596.0,1798.0,19.8,113889.0,1036,36027140302
36,027,140302,2,Block Group 2; Census Tract 1403.02; Dutchess County; New York,325,148,473,142,41,0,0,27,115,0,148,473,26,35,28,59,0,325,2005,2016,2018,1093.0,1288.0,1609.0,32.1,72933.0,850,36027140302
36,027,140302,3,Block Group 3; Census Tract 1403.02; Dutchess County; New York,216,29,245,23,0,0,0,14,179,0,29,245,0,0,29,0,0,216,-666666666,2014,2014,1080.0,1160.0,1240.0,12.8,114698.0,768,36027140302
36,027,140400,1,Block Group 1; Census Tract 1404; Dutchess County; New York,9,572,581,0,0,0,0,0,9,20,572,581,187,150,130,68,17,9,1997,1997,-666666666,,,,,139750.0,1617,36027140400
36,027,140400,2,Block Group 2; Census Tract 1404; Dutchess County; New York,141,684,825,9,0,0,125,0,7,8,684,825,150,76,250,110,90,141,2005,2002,1996,,,,,130673.0,2061,36027140400
36,027,140400,3,Block Group 3; Census Tract 1404; Dutchess County; New York,34,570,604,16,0,0,0,0,18,9,570,604,106,88,192,153,22,34,2005,2006,2018,1060.0,3501.0,3501.0,51.0,138438.0,1629,36027140400
36,027,140500,1,Block Group 1; Census Tract 1405; Dutchess County; New York,278,419,697,67,0,0,52,45,114,0,419,697,67,74,167,77,34,278,2004,2007,2013,386.0,442.0,1210.0,22.3,47054.0,1185,36027140500
36,027,140500,2,Block Group 2; Census Tract 1405; Dutchess County; New York,47,209,256,40,0,0,0,0,7,0,209,256,30,50,25,104,0,47,2010,2012,-666666666,,,,,148452.0,731,36027140500
36,027,140500,3,Block Group 3; Census Tract 1405; Dutchess County; New York,407,0,407,163,36,0,6,0,202,0,0,407,0,0,0,0,0,407,-666666666,2018,2018,1404.0,1598.0,1817.0,27.8,77768.0,701,36027140500
36,027,140602,1,Block Group 1; Census Tract 1406.02; Dutchess County; New York,169,443,612,0,0,0,48,31,90,0,443,612,133,102,72,119,17,169,1999,2002,2010,1256.0,1343.0,1431.0,33.7,103382.0,1909,36027140602
36,027,140602,2,Block Group 2; Census Tract 1406.02; Dutchess County; New York,0,440,440,0,0,0,0,0,0,12,440,440,86,20,269,18,35,0,2004,2004,-666666666,,,,,123880.0,1121,36027140602
36,027,140700,1,Block Group 1; Census Tract 1407; Dutchess County; New York,127,568,695,0,30,0,24,4,69,26,568,695,58,87,171,149,77,127,2008,2010,2014,1022.0,1114.0,1205.0,51.0,120898.0,1817,36027140700
36,027,140700,2,Block Group 2; Census Tract 1407; Dutchess County; New York,57,144,201,0,0,48,0,0,9,0,144,201,31,70,0,20,23,57,1996,1993,-666666666,,,,,127303.0,503,36027140700
36,027,140700,3,Block Group 3; Census Tract 1407; Dutchess County; New York,0,554,554,0,0,0,0,0,0,8,554,554,83,108,191,116,48,0,2005,2005,-666666666,,,,,163125.0,1706,36027140700
36,027,140700,4,Block Group 4; Census Tract 1407; Dutchess County; New York,106,561,667,0,0,0,0,106,0,0,561,667,112,154,134,155,6,106,2001,2003,-666666666,,,,,132286.0,2061,36027140700
36,027,140700,5,Block Group 5; Census Tract 1407; Dutchess County; New York,0,328,328,0,0,0,0,0,0,0,328,328,76,147,6,29,70,0,1996,1996,-666666666,,,,,190739.0,976,36027140700
36,027,140801,1,Block Group 1; Census Tract 1408.01; Dutchess County; New York,20,287,307,8,12,0,0,0,0,0,287,307,56,23,148,28,32,20,2004,2005,-666666666,,,,,58491.0,564,36027140801
36,027,140801,2,Block Group 2; Census Tract 1408.01; Dutchess County; New York,52,481,533,0,0,0,0,0,52,26,481,533,147,39,150,62,57,52,2004,2005,-666666666,,,,,130551.0,1319,36027140801
36,027,140801,3,Block Group 3; Census Tract 1408.01; Dutchess County; New York,30,247,277,0,0,0,30,0,0,0,247,277,95,5,63,75,9,30,2004,2001,-666666666,,,,,130744.0,733,36027140801
36,027,150003,1,Block Group 1; Census Tract 1500.03; Dutchess County; New York,181,185,366,54,34,0,10,31,52,5,185,366,47,26,32,57,18,181,2006,2013,2018,827.0,1201.0,2061.0,51.0,44583.0,802,36027150003
36,027,150003,2,Block Group 2; Census Tract 1500.03; Dutchess County; New York,68,23,91,0,0,0,0,0,68,0,23,91,5,0,4,14,0,68,2011,2014,-666666666,935.0,970.0,1056.0,9.0,200354.0,954,36027150003
36,027,150003,3,Block Group 3; Census Tract 1500.03; Dutchess County; New York,67,119,186,18,0,6,16,23,4,0,119,186,32,25,20,20,22,67,2001,2003,2005,1121.0,1425.0,1785.0,18.7,92381.0,924,36027150003
36,027,150004,1,Block Group 1; Census Tract 1500.04; Dutchess County; New York,21,291,312,0,0,0,16,5,0,0,291,312,101,23,18,127,22,21,2010,2007,-666666666,1285.0,1389.0,1493.0,51.0,98182.0,826,36027150004
36,027,150004,2,Block Group 2; Census Tract 1500.04; Dutchess County; New York,83,441,524,27,0,0,0,0,56,10,441,524,59,85,170,69,48,83,2005,2007,2016,1279.0,1385.0,1491.0,18.3,128571.0,1365,36027150004
36,027,150004,3,Block Group 3; Census Tract 1500.04; Dutchess County; New York,34,215,249,7,6,0,0,6,15,9,215,249,52,46,86,14,8,34,2001,2003,2016,1203.0,1639.0,1819.0,20.3,143170.0,838,36027150004
36,027,150005,1,Block Group 1; Census Tract 1500.05; Dutchess County; New York,23,355,378,9,11,0,0,0,3,26,355,378,75,77,112,32,33,23,2002,2003,2021,1326.0,1486.0,1739.0,22.1,115000.0,960,36027150005
36,027,150005,2,Block Group 2; Census Tract 1500.05; Dutchess County; New York,27,470,497,0,14,0,0,5,8,0,470,497,34,121,138,142,35,27,2006,2007,2022,1179.0,2045.0,2240.0,51.0,144063.0,1545,36027150005
36,027,150006,1,Block Group 1; Census Tract 1500.06; Dutchess County; New York,160,266,426,27,33,0,0,42,58,0,266,426,35,35,72,54,70,160,2009,2012,2015,760.0,850.0,1464.0,39.0,78594.0,970,36027150006
36,027,150006,2,Block Group 2; Census Tract 1500.06; Dutchess County; New York,158,281,439,72,29,0,0,3,54,22,281,439,50,39,127,20,23,158,2004,2010,2019,941.0,1190.0,1422.0,33.1,96484.0,846,36027150006
36,027,160003,1,Block Group 1; Census Tract 1600.03; Dutchess County; New York,97,440,537,23,14,0,0,0,60,24,440,537,184,24,54,97,57,97,2002,2010,2016,1439.0,2386.0,2918.0,22.1,126726.0,1226,36027160003
36,027,160003,2,Block Group 2; Census Tract 1600.03; Dutchess County; New York,110,126,236,77,0,5,23,0,5,0,126,236,17,23,40,46,0,110,2006,2012,2019,960.0,1153.0,1424.0,39.3,103750.0,656,36027160003
36,027,160003,3,Block Group 3; Census Tract 1600.03; Dutchess County; New York,45,248,293,19,0,0,0,10,16,0,248,293,119,21,55,47,6,45,1992,2001,2016,1076.0,1193.0,1740.0,45.7,144904.0,718,36027160003
36,027,160004,1,Block Group 1; Census Tract 1600.04; Dutchess County; New York,90,384,474,37,0,0,16,9,28,0,384,474,217,35,62,31,39,90,1989,1994,2016,1061.0,1196.0,1567.0,34.3,,861,36027160004
36,027,160004,2,Block Group 2; Census Tract 1600.04; Dutchess County; New York,148,481,629,21,0,0,0,5,122,0,481,629,58,56,174,172,21,148,2007,2011,2015,874.0,960.0,1862.0,42.1,124750.0,1453,36027160004
36,027,160005,1,Block Group 1; Census Tract 1600.05; Dutchess County; New York,153,385,538,65,0,0,10,65,13,9,385,538,54,82,80,81,79,153,2007,2008,2011,1229.0,1545.0,1773.0,46.3,93158.0,1055,36027160005
36,027,160005,2,Block Group 2; Census Tract 1600.05; Dutchess County; New York,351,198,549,164,0,0,0,0,187,10,198,549,10,35,44,75,24,351,2011,2016,2018,1035.0,1330.0,1464.0,31.4,49514.0,887,36027160005
36,027,160005,3,Block Group 3; Census Tract 1600.05; Dutchess County; New York,135,230,365,32,0,0,0,0,103,11,230,365,60,13,52,69,25,135,2008,2013,2015,1087.0,1201.0,1735.0,22.8,74409.0,751,36027160005
36,027,170000,1,Block Group 1; Census Tract 1700; Dutchess County; New York,26,278,304,0,0,0,0,0,26,0,278,304,66,80,82,29,21,26,1999,2001,-666666666,978.0,1119.0,1352.0,24.9,151563.0,787,36027170000
36,027,170000,2,Block Group 2; Census Tract 1700; Dutchess County; New York,82,556,638,9,8,0,8,23,34,0,556,638,104,155,129,113,55,82,2001,2003,2012,1035.0,1132.0,1229.0,34.5,94375.0,1483,36027170000
36,027,170000,3,Block Group 3; Census Tract 1700; Dutchess County; New York,67,229,296,0,0,0,0,36,31,7,229,296,33,8,120,49,12,67,2006,2007,2009,,1129.0,1347.0,14.3,73971.0,549,36027170000
36,027,170000,4,Block Group 4; Census Tract 1700; Dutchess County; New York,91,160,251,14,36,0,0,0,41,0,160,251,21,41,46,44,8,91,2004,2012,2019,1595.0,1861.0,2357.0,26.3,81563.0,873,36027170000
36,027,180001,1,Block Group 1; Census Tract 1800.01; Dutchess County; New York,187,411,598,88,0,0,0,0,99,0,411,598,72,117,107,100,15,187,2002,2010,2018,1035.0,1330.0,2330.0,28.9,76786.0,1225,36027180001
36,027,180001,2,Block Group 2; Census Tract 1800.01; Dutchess County; New York,0,327,327,0,0,0,0,0,0,0,327,327,55,125,86,34,27,0,1999,1999,-666666666,,,,,108214.0,823,36027180001
36,027,180001,3,Block Group 3; Census Tract 1800.01; Dutchess County; New York,23,346,369,0,0,0,0,0,23,0,346,369,90,46,75,127,8,23,2005,2006,-666666666,,,,,134427.0,1097,36027180001
36,027,180001,4,Block Group 4; Census Tract 1800.01; Dutchess County; New York,0,374,374,0,0,0,0,0,0,0,374,374,45,46,95,101,87,0,2010,2010,-666666666,,,,,75682.0,1429,36027180001
36,027,190101,1,Block Group 1; Census Tract 1901.01; Dutchess County; New York,0,339,339,0,0,0,0,0,0,0,339,339,108,109,39,60,23,0,1996,1996,-666666666,,,,,144659.0,938,36027190101
36,027,190101,2,Block Group 2; Census Tract 1901.01; Dutchess County; New York,7,434,441,0,0,0,0,7,0,15,434,441,132,90,44,124,29,7,1999,2000,-666666666,,,,,137721.0,1127,36027190101
36,027,190101,3,Block Group 3; Census Tract 1901.01; Dutchess County; New York,0,499,499,0,0,0,0,0,0,0,499,499,44,109,100,184,62,0,2010,2010,-666666666,,,,,149025.0,1403,36027190101
36,027,190102,1,Block Group 1; Census Tract 1901.02; Dutchess County; New York,389,164,553,89,0,4,19,86,191,0,164,553,80,11,51,6,16,389,1992,2011,2014,1288.0,1442.0,1834.0,20.4,90693.0,1637,36027190102
36,027,190102,2,Block Group 2; Census Tract 1901.02; Dutchess County; New York,14,237,251,0,0,0,5,9,0,0,237,251,77,66,62,28,4,14,1996,1997,2002,,,,,155074.0,695,36027190102
36,027,190203,1,Block Group 1; Census Tract 1902.03; Dutchess County; New York,182,479,661,101,0,0,17,5,59,8,479,661,62,58,166,131,54,182,2007,2011,2018,1007.0,1161.0,1693.0,24.3,88672.0,1494,36027190203
36,027,190203,2,Block Group 2; Census Tract 1902.03; Dutchess County; New York,9,255,264,0,0,0,0,0,9,0,255,264,72,65,9,64,45,9,1999,1999,-666666666,,,,,168438.0,982,36027190203
36,027,190204,1,Block Group 1; Census Tract 1902.04; Dutchess County; New York,0,514,514,0,0,0,0,0,0,18,514,514,138,77,80,164,37,0,2005,2005,-666666666,,,,,114423.0,1794,36027190204
36,027,190204,2,Block Group 2; Census Tract 1902.04; Dutchess County; New York,75,326,401,0,0,25,0,0,50,0,326,401,72,23,45,119,67,75,2012,2012,2012,944.0,987.0,1133.0,51.0,144125.0,1120,36027190204
36,027,190204,3,Block Group 3; Census Tract 1902.04; Dutchess County; New York,10,561,571,10,0,0,0,0,0,10,561,571,85,119,112,116,119,10,2007,2007,-666666666,,,,,120750.0,1460,36027190204
36,027,190204,4,Block Group 4; Census Tract 1902.04; Dutchess County; New York,41,421,462,4,0,0,0,0,37,33,421,462,61,120,86,58,63,41,2003,2006,-666666666,,,,,119550.0,1140,36027190204
36,027,190301,1,Block Group 1; Census Tract 1903.01; Dutchess County; New York,98,304,402,0,12,0,20,0,66,0,304,402,81,19,109,69,26,98,2005,2007,2014,1094.0,1188.0,1351.0,25.4,75652.0,872,36027190301
36,027,190301,2,Block Group 2; Census Tract 1903.01; Dutchess County; New York,350,49,399,85,43,0,0,23,199,0,49,399,7,23,7,12,0,350,1998,2015,2016,1573.0,1726.0,1880.0,23.5,103666.0,875,36027190301
36,027,190301,3,Block Group 3; Census Tract 1903.01; Dutchess County; New York,691,209,900,237,54,0,11,16,373,0,209,900,51,68,17,40,33,691,1998,2016,2017,1530.0,1703.0,1877.0,29.3,80714.0,1930,36027190301
36,027,190401,1,Block Group 1; Census Tract 1904.01; Dutchess County; New York,158,329,487,12,0,0,0,97,49,0,329,487,85,62,103,59,20,158,2002,2005,2008,1210.0,1450.0,2050.0,24.8,118630.0,1382,36027190401
36,027,190401,2,Block Group 2; Census Tract 1904.01; Dutchess County; New York,94,293,387,38,11,0,0,15,30,19,293,387,67,40,53,73,41,94,2007,2011,2018,1040.0,1250.0,1444.0,29.0,91250.0,963,36027190401
36,027,190402,1,Block Group 1; Census Tract 1904.02; Dutchess County; New York,360,545,905,118,11,0,0,108,123,11,545,905,55,56,329,53,41,360,2005,2008,2015,890.0,1041.0,1207.0,30.4,64856.0,1794,36027190402
36,027,190402,2,Block Group 2; Census Tract 1904.02; Dutchess County; New York,21,477,498,10,0,0,11,0,0,17,477,498,135,116,66,134,9,21,1999,1999,-666666666,,,,,117692.0,1457,36027190402
36,027,200001,1,Block Group 1; Census Tract 2000.01; Dutchess County; New York,66,303,369,0,0,0,0,26,40,0,303,369,111,33,50,55,54,66,2002,2005,2011,99.0,99.0,791.0,9.0,105417.0,855,36027200001
36,027,200001,2,Block Group 2; Census Tract 2000.01; Dutchess County; New York,48,336,384,0,0,39,0,0,9,15,336,384,88,186,7,40,0,48,1994,1993,-666666666,,,,,,662,36027200001
36,027,200001,3,Block Group 3; Census Tract 2000.01; Dutchess County; New York,292,499,791,119,0,0,0,85,88,0,499,791,127,140,98,120,14,292,1999,2007,2016,861.0,1202.0,1436.0,30.3,79521.0,1601,36027200001
36,027,200002,1,Block Group 1; Census Tract 2000.02; Dutchess County; New York,355,383,738,88,0,10,3,40,214,0,383,738,53,64,62,144,60,355,2011,2013,2015,753.0,981.0,1192.0,27.1,71477.0,1382,36027200002
36,027,210101,1,Block Group 1; Census Tract 2101.01; Dutchess County; New York,403,215,618,81,18,29,0,33,242,73,215,618,57,0,60,25,0,403,2008,2014,2015,1134.0,1314.0,1466.0,29.5,70582.0,1556,36027210101
36,027,210101,2,Block Group 2; Census Tract 2101.01; Dutchess County; New York,189,75,264,42,28,0,0,50,69,0,75,264,51,0,0,0,24,189,-666666666,2014,2015,1050.0,1387.0,1663.0,28.7,38750.0,474,36027210101
36,027,210101,3,Block Group 3; Census Tract 2101.01; Dutchess County; New York,57,570,627,25,0,0,0,0,32,0,570,627,86,32,338,99,15,57,2005,2006,-666666666,,,,,157766.0,1850,36027210101
36,027,210101,4,Block Group 4; Census Tract 2101.01; Dutchess County; New York,121,259,380,0,18,0,0,0,103,0,259,380,44,49,166,0,0,121,2002,2006,2015,1361.0,1597.0,1799.0,51.0,83654.0,663,36027210101
36,027,210101,5,Block Group 5; Census Tract 2101.01; Dutchess County; New York,233,128,361,116,37,0,0,10,70,45,128,361,0,0,0,83,0,233,2016,2018,2019,1688.0,1693.0,1947.0,19.2,75841.0,536,36027210101
36,027,210201,1,Block Group 1; Census Tract 2102.01; Dutchess County; New York,176,197,373,65,0,0,5,24,82,9,197,373,19,0,42,62,65,176,2015,2015,2016,1009.0,1636.0,2021.0,27.2,95417.0,907,36027210201
36,027,210201,2,Block Group 2; Census Tract 2102.01; Dutchess County; New York,133,255,388,61,0,0,0,0,72,11,255,388,22,147,32,30,13,133,1997,2008,2017,1339.0,1728.0,2060.0,27.9,113636.0,777,36027210201
36,027,210201,3,Block Group 3; Census Tract 2102.01; Dutchess County; New York,312,156,468,110,0,0,23,46,133,0,156,468,15,15,76,50,0,312,2006,2013,2015,276.0,409.0,1125.0,27.8,47868.0,1098,36027210201
36,027,210201,4,Block Group 4; Census Tract 2102.01; Dutchess County; New York,177,232,409,38,48,0,0,33,58,0,232,409,71,35,41,32,53,177,2002,2012,2018,1604.0,1767.0,1929.0,25.4,104962.0,1052,36027210201
36,027,210201,5,Block Group 5; Census Tract 2102.01; Dutchess County; New York,0,187,187,0,0,0,0,0,0,11,187,187,0,41,78,32,25,0,2007,2007,-666666666,,,,,171202.0,450,36027210201
36,027,210301,1,Block Group 1; Census Tract 2103.01; Dutchess County; New York,275,296,571,67,16,13,98,11,70,21,296,571,22,64,88,39,62,275,2007,2009,2012,959.0,1319.0,1681.0,22.4,81573.0,1545,36027210301
36,027,210301,2,Block Group 2; Census Tract 2103.01; Dutchess County; New York,6,226,232,0,6,0,0,0,0,0,226,232,51,8,97,27,43,6,2006,2006,-666666666,,,,,168906.0,591,36027210301
36,027,210301,3,Block Group 3; Census Tract 2103.01; Dutchess County; New York,169,526,695,23,38,0,0,0,108,0,526,695,122,71,174,114,45,169,2004,2009,2016,1613.0,1862.0,2199.0,28.2,115820.0,1699,36027210301
36,027,210301,4,Block Group 4; Census Tract 2103.01; Dutchess County; New York,18,224,242,0,0,0,0,0,18,0,224,242,72,14,18,105,15,18,2011,2011,-666666666,,,,,97321.0,649,36027210301
36,027,220101,1,Block Group 1; Census Tract 2201.01; Dutchess County; New York,522,50,572,55,11,0,61,64,331,19,50,572,0,0,16,15,0,522,2015,2013,2013,807.0,874.0,982.0,51.0,23897.0,937,36027220101
36,027,220101,2,Block Group 2; Census Tract 2201.01; Dutchess County; New York,213,118,331,0,28,0,0,85,100,0,118,331,0,0,0,95,23,213,2015,2013,2012,972.0,1431.0,2097.0,34.2,55929.0,960,36027220101
36,027,220101,3,Block Group 3; Census Tract 2201.01; Dutchess County; New York,335,92,427,149,19,5,0,0,162,0,92,427,80,0,0,12,0,335,1989,2016,2018,830.0,1286.0,1708.0,43.0,57787.0,973,36027220101
36,027,220101,4,Block Group 4; Census Tract 2201.01; Dutchess County; New York,336,45,381,69,61,0,0,13,193,0,45,381,31,0,0,0,14,336,-666666666,2016,2016,938.0,989.0,1529.0,17.1,91045.0,999,36027220101
36,027,220102,1,Block Group 1; Census Tract 2201.02; Dutchess County; New York,428,0,428,199,23,0,0,74,132,0,0,428,0,0,0,0,0,428,-666666666,2018,2018,316.0,679.0,1176.0,43.8,45476.0,856,36027220102
36,027,220102,2,Block Group 2; Census Tract 2201.02; Dutchess County; New York,42,0,42,19,0,0,23,0,0,0,0,42,0,0,0,0,0,42,-666666666,1999,1999,1659.0,1818.0,1977.0,19.6,117717.0,85,36027220102
36,027,220201,1,Block Group 1; Census Tract 2202.01; Dutchess County; New York,263,0,263,130,47,0,0,13,73,0,0,263,0,0,0,0,0,263,-666666666,2019,2019,1029.0,1171.0,1521.0,41.1,33109.0,452,36027220201
36,027,220201,2,Block Group 2; Census Tract 2202.01; Dutchess County; New York,237,62,299,30,16,0,42,0,149,0,62,299,12,0,41,9,0,237,2005,2013,2014,1106.0,1251.0,1376.0,51.0,77848.0,776,36027220201
36,027,220201,3,Block Group 3; Census Tract 2202.01; Dutchess County; New York,243,192,435,139,0,0,0,18,86,0,192,435,54,15,55,43,25,243,2005,2015,2018,1207.0,3025.0,3263.0,46.3,74234.0,1777,36027220201
36,027,220201,4,Block Group 4; Census Tract 2202.01; Dutchess County; New York,253,94,347,38,17,0,0,15,183,0,94,347,25,17,20,32,0,253,2003,2014,2015,1085.0,1263.0,1410.0,28.9,80104.0,1248,36027220201
36,027,220300,1,Block Group 1; Census Tract 2203; Dutchess County; New York,460,211,671,139,35,0,0,18,268,24,211,671,33,63,35,33,23,460,2003,2015,2016,418.0,566.0,809.0,28.9,38042.0,1435,36027220300
36,027,220300,2,Block Group 2; Census Tract 2203; Dutchess County; New York,567,43,610,182,0,28,0,84,273,12,43,610,10,0,9,12,0,567,2012,2015,2015,249.0,1006.0,1345.0,28.8,17401.0,1187,36027220300
36,027,220300,3,Block Group 3; Census Tract 2203; Dutchess County; New York,173,145,318,84,0,0,23,10,56,0,145,318,81,0,0,9,55,173,1989,2016,2018,1171.0,1366.0,1537.0,51.0,64667.0,1206,36027220300
36,027,220300,4,Block Group 4; Census Tract 2203; Dutchess County; New York,116,74,190,0,0,0,0,15,101,0,74,190,53,0,0,21,0,116,1989,2012,2013,891.0,1046.0,1167.0,51.0,35833.0,573,36027220300
36,027,220700,1,Block Group 1; Census Tract 2207; Dutchess County; New York,115,245,360,81,0,0,0,3,31,0,245,360,29,23,93,52,48,115,2008,2013,2019,1357.0,1477.0,1724.0,51.0,60000.0,680,36027220700
36,027,220700,2,Block Group 2; Census Tract 2207; Dutchess County; New York,301,106,407,38,0,0,19,55,189,0,106,407,50,0,32,0,24,301,2001,2012,2013,1063.0,1257.0,1455.0,51.0,50391.0,950,36027220700
36,027,220700,3,Block Group 3; Census Tract 2207; Dutchess County; New York,385,0,385,115,12,30,13,71,144,0,0,385,0,0,0,0,0,385,-666666666,2014,2014,672.0,961.0,2149.0,21.6,81696.0,1030,36027220700
36,027,220801,1,Block Group 1; Census Tract 2208.01; Dutchess County; New York,210,269,479,40,0,0,0,111,59,0,269,479,65,23,66,83,32,210,2007,2009,2009,666.0,683.0,1390.0,11.0,143125.0,785,36027220801
36,027,220801,2,Block Group 2; Census Tract 2208.01; Dutchess County; New York,219,0,219,39,0,0,0,47,133,0,0,219,0,0,0,0,0,219,-666666666,2014,2014,716.0,740.0,1035.0,51.0,16298.0,441,36027220801
36,027,220801,3,Block Group 3; Census Tract 2208.01; Dutchess County; New York,109,252,361,0,23,0,0,0,86,0,252,361,22,18,112,66,34,109,2008,2012,2015,912.0,988.0,1114.0,29.6,129958.0,662,36027220801
36,027,220801,4,Block Group 4; Census Tract 2208.01; Dutchess County; New York,303,63,366,68,0,0,0,25,210,3,63,366,18,0,18,7,17,303,2008,2014,2015,890.0,1076.0,1222.0,47.4,70429.0,735,36027220801
36,027,220801,5,Block Group 5; Census Tract 2208.01; Dutchess County; New York,245,217,462,100,0,0,0,0,145,18,217,462,0,0,88,99,12,245,2012,2015,2017,904.0,1217.0,1370.0,51.0,32179.0,879,36027220801
36,027,220901,1,Block Group 1; Census Tract 2209.01; Dutchess County; New York,215,226,441,95,0,80,0,9,31,0,226,441,124,26,29,0,47,215,1989,1996,2015,967.0,1051.0,1150.0,35.2,49855.0,943,36027220901
36,027,220901,2,Block Group 2; Census Tract 2209.01; Dutchess County; New York,261,117,378,113,0,0,0,148,0,0,117,378,29,70,18,0,0,261,1994,2005,2009,972.0,1215.0,1433.0,35.2,54115.0,655,36027220901
36,027,220901,3,Block Group 3; Census Tract 2209.01; Dutchess County; New York,257,74,331,0,109,13,0,18,117,0,74,331,8,35,8,23,0,257,1998,2015,2017,942.0,1048.0,1157.0,51.0,16130.0,904,36027220901
36,027,220901,4,Block Group 4; Census Tract 2209.01; Dutchess County; New York,189,418,607,76,0,0,0,17,96,6,418,607,74,68,203,63,4,189,2003,2007,2016,1042.0,1191.0,1752.0,19.8,94659.0,1703,36027220901
36,027,221001,1,Block Group 1; Census Tract 2210.01; Dutchess County; New York,72,437,509,5,9,0,0,0,58,27,437,509,8,46,174,162,20,72,2009,2011,2015,1580.0,1839.0,2138.0,35.0,89625.0,809,36027221001
36,027,221001,2,Block Group 2; Census Tract 2210.01; Dutchess County; New York,0,506,506,0,0,0,0,0,0,14,506,506,109,86,190,52,55,0,2003,2003,-666666666,,,,,126797.0,1208,36027221001
36,027,221001,3,Block Group 3; Census Tract 2210.01; Dutchess County; New York,27,453,480,0,0,0,0,0,27,17,453,480,78,59,106,84,109,27,2008,2010,-666666666,,,,,110530.0,1249,36027221001
36,027,221001,4,Block Group 4; Census Tract 2210.01; Dutchess County; New York,0,323,323,0,0,0,0,0,0,20,323,323,96,33,67,77,30,0,2005,2005,-666666666,,,,,97031.0,611,36027221001
36,027,221100,1,Block Group 1; Census Tract 2211; Dutchess County; New York,293,61,354,42,0,24,0,53,174,0,61,354,29,5,0,27,0,293,1993,2013,2013,1024.0,1195.0,1783.0,44.6,41227.0,1146,36027221100
36,027,221100,2,Block Group 2; Census Tract 2211; Dutchess County; New York,231,179,410,41,0,0,28,18,144,0,179,410,42,73,31,33,0,231,1997,2011,2014,1095.0,1295.0,1466.0,51.0,47778.0,1312,36027221100
36,027,221100,3,Block Group 3; Census Tract 2211; Dutchess County; New York,561,0,561,259,0,0,0,6,296,0,0,561,0,0,0,0,0,561,-666666666,2017,2017,1003.0,1200.0,1403.0,22.9,70523.0,1069,36027221100
36,027,221100,4,Block Group 4; Census Tract 2211; Dutchess County; New York,321,17,338,32,19,0,41,55,174,0,17,338,17,0,0,0,0,321,-666666666,2013,2013,838.0,904.0,982.0,51.0,16807.0,482,36027221100
36,027,300000,1,Block Group 1; Census Tract 3000; Dutchess County; New York,253,97,350,43,51,0,89,39,31,0,97,350,56,18,0,23,0,253,1989,2003,2010,1097.0,1319.0,1664.0,51.0,35103.0,644,36027300000
36,027,300000,2,Block Group 2; Census Tract 3000; Dutchess County; New York,318,72,390,0,28,28,0,135,127,0,72,390,32,34,6,0,0,318,1991,2007,2010,946.0,1142.0,1507.0,28.0,60351.0,699,36027300000
36,027,300000,3,Block Group 3; Census Tract 3000; Dutchess County; New York,114,344,458,36,0,0,0,10,68,23,344,458,125,27,150,19,0,114,2001,2005,2016,1102.0,1204.0,1338.0,32.6,74444.0,1255,36027300000
36,027,300000,4,Block Group 4; Census Tract 3000; Dutchess County; New York,359,250,609,46,45,0,0,68,200,0,250,609,43,3,115,89,0,359,2007,2012,2014,961.0,1126.0,1655.0,31.7,77773.0,1768,36027300000
36,027,300000,5,Block Group 5; Census Tract 3000; Dutchess County; New York,681,27,708,149,37,59,0,48,388,0,27,708,0,0,0,27,0,681,-666666666,2015,2015,1053.0,1211.0,1430.0,32.2,59018.0,1409,36027300000
36,027,410000,1,Block Group 1; Census Tract 4100; Dutchess County; New York,63,72,135,0,52,0,0,0,11,0,72,135,12,10,10,36,4,63,2011,2016,2022,2046.0,2197.0,2349.0,51.0,,2365,36027410000
36,027,410000,2,Block Group 2; Census Tract 4100; Dutchess County; New York,15,352,367,0,4,0,0,0,11,0,352,367,116,77,44,72,43,15,1998,1999,-666666666,,,,,97163.0,881,36027410000
36,027,410000,3,Block Group 3; Census Tract 4100; Dutchess County; New York,236,59,295,34,21,0,14,96,71,0,59,295,4,15,22,0,18,236,2005,2010,2011,1117.0,1248.0,1383.0,23.0,81964.0,647,36027410000
36,027,610000,1,Block Group 1; Census Tract 6100; Dutchess County; New York,40,0,40,40,0,0,0,0,0,0,0,40,0,0,0,0,0,40,-666666666,-666666666,-666666666,,,,,,1748,36027610000
36,027,640001,1,Block Group 1; Census Tract 6400.01; Dutchess County; New York,0,0,0,0,0,0,0,0,0,0,0,0,0,0,0,0,0,0,-666666666,-666666666,-666666666,,,,,,897,36027640001
36,027,640002,1,Block Group 1; Census Tract 6400.02; Dutchess County; New York,0,0,0,0,0,0,0,0,0,0,0,0,0,0,0,0,0,0,-666666666,-666666666,-666666666,,,,,,536,36027640002
36,039,080100,1,Block Group 1; Census Tract 801; Greene County; New York,46,445,491,0,0,0,0,0,46,33,445,491,126,82,145,26,33,46,2001,2003,-666666666,,,,,93542.0,1171,36039080100
36,039,080100,2,Block Group 2; Census Tract 801; Greene County; New York,79,351,430,25,0,0,0,24,30,0,351,430,141,53,106,23,28,79,1997,2002,2014,691.0,1079.0,1244.0,25.9,72464.0,1406,36039080100
36,039,080100,3,Block Group 3; Census Tract 801; Greene County; New York,0,213,213,0,0,0,0,0,0,0,213,213,46,62,53,52,0,0,2000,2000,-666666666,,,,,98427.0,653,36039080100
36,039,080201,1,Block Group 1; Census Tract 802.01; Greene County; New York,64,273,337,35,0,0,0,0,29,7,273,337,64,22,106,69,5,64,2005,2008,2018,640.0,679.0,723.0,27.5,103906.0,828,36039080201
36,039,080201,2,Block Group 2; Census Tract 802.01; Greene County; New York,141,471,612,21,0,0,10,0,110,16,471,612,96,60,119,142,38,141,2007,2011,2014,585.0,832.0,1314.0,24.5,78603.0,1710,36039080201
36,039,080201,3,Block Group 3; Census Tract 802.01; Greene County; New York,21,423,444,0,0,0,0,0,21,0,423,444,94,41,158,111,19,21,2005,2006,-666666666,,,,,54063.0,1227,36039080201
36,039,080202,1,Block Group 1; Census Tract 802.02; Greene County; New York,50,377,427,17,24,0,9,0,0,6,377,427,78,84,64,112,33,50,2004,2007,2021,521.0,543.0,581.0,9.0,54531.0,1011,36039080202
36,039,080202,2,Block Group 2; Census Tract 802.02; Greene County; New York,137,534,671,56,0,0,0,21,60,22,534,671,67,136,93,178,38,137,2007,2011,2016,754.0,779.0,1003.0,51.0,68958.0,1630,36039080202
36,039,080402,1,Block Group 1; Census Tract 804.02; Greene County; New York,19,392,411,5,0,0,0,7,7,13,392,411,55,91,66,94,73,19,2008,2008,2013,656.0,750.0,1031.0,25.0,76250.0,1013,36039080402
36,039,080402,2,Block Group 2; Census Tract 804.02; Greene County; New York,29,377,406,4,0,0,3,3,19,3,377,406,154,79,79,45,17,29,1994,1996,2014,691.0,950.0,1063.0,18.9,59000.0,1030,36039080402
36,039,080403,1,Block Group 1; Census Tract 804.03; Greene County; New York,166,350,516,23,0,0,50,44,49,0,350,516,129,27,176,18,0,166,2001,2002,2008,99.0,99.0,940.0,19.0,107422.0,1273,36039080403
36,039,080404,1,Block Group 1; Census Tract 804.04; Greene County; New York,52,227,279,7,0,4,0,0,41,4,227,279,10,62,65,62,24,52,2006,2010,2014,636.0,860.0,1058.0,51.0,63068.0,1367,36039080404
36,039,080404,2,Block Group 2; Census Tract 804.04; Greene County; New York,132,105,237,0,0,0,55,64,13,0,105,237,17,16,26,34,12,132,2008,2003,2002,901.0,948.0,996.0,51.0,,388,36039080404
36,039,080501,1,Block Group 1; Census Tract 805.01; Greene County; New York,130,428,558,52,0,0,0,50,28,0,428,558,77,88,67,128,68,130,2007,2010,2014,575.0,650.0,2213.0,41.7,58989.0,1414,36039080501
36,039,080501,2,Block Group 2; Census Tract 805.01; Greene County; New York,158,350,508,150,0,0,0,0,8,0,350,508,104,108,41,97,0,158,1997,2010,-666666666,812.0,859.0,1082.0,51.0,57375.0,1312,36039080501
36,039,080502,1,Block Group 1; Census Tract 805.02; Greene County; New York,65,368,433,14,0,0,0,29,22,0,368,433,74,56,88,91,59,65,2006,2007,2011,848.0,975.0,1110.0,22.5,92629.0,1232,36039080502
36,039,080502,2,Block Group 2; Census Tract 805.02; Greene County; New York,160,229,389,11,37,0,0,23,89,0,229,389,20,39,94,43,33,160,2006,2011,2015,372.0,1042.0,1265.0,28.0,53594.0,1111,36039080502
36,039,080502,3,Block Group 3; Census Tract 805.02; Greene County; New York,191,207,398,66,0,0,14,12,99,0,207,398,38,31,50,66,22,191,2007,2013,2016,,1053.0,1151.0,22.3,47250.0,971,36039080502
36,039,080502,4,Block Group 4; Census Tract 805.02; Greene County; New York,2,154,156,0,0,0,0,0,2,0,154,156,21,56,52,25,0,2,2000,2000,-666666666,,,,,91146.0,653,36039080502
36,039,080600,1,Block Group 1; Census Tract 806; Greene County; New York,70,572,642,0,13,0,0,11,46,0,572,642,204,169,168,21,10,70,1995,1997,2014,763.0,1042.0,1178.0,13.8,99314.0,1732,36039080600
36,039,080600,2,Block Group 2; Census Tract 806; Greene County; New York,26,587,613,0,0,19,0,0,7,19,587,613,22,57,259,182,48,26,2008,2008,-666666666,628.0,917.0,1011.0,,61886.0,1364,36039080600
36,039,080600,3,Block Group 3; Census Tract 806; Greene County; New York,80,78,158,0,32,0,0,48,0,0,78,158,24,8,10,27,9,80,2007,2008,2008,471.0,492.0,630.0,35.8,88438.0,377,36039080600
36,039,080700,1,Block Group 1; Census Tract 807; Greene County; New York,208,138,346,80,0,0,8,57,63,0,138,346,75,21,6,27,9,208,1989,2011,2015,394.0,521.0,585.0,25.9,39630.0,738,36039080700
36,039,080700,2,Block Group 2; Census Tract 807; Greene County; New York,49,245,294,0,14,0,0,0,35,0,245,294,48,21,18,144,14,49,2012,2013,2016,813.0,860.0,1281.0,27.7,142984.0,879,36039080700
36,039,080700,3,Block Group 3; Census Tract 807; Greene County; New York,212,282,494,62,0,14,0,26,110,0,282,494,59,28,108,29,58,212,2005,2011,2015,646.0,793.0,956.0,21.3,68542.0,1203,36039080700
36,039,080800,1,Block Group 1; Census Tract 808; Greene County; New York,0,0,0,0,0,0,0,0,0,0,0,0,0,0,0,0,0,0,-666666666,-666666666,-666666666,,,,,,2030,36039080800
36,039,080900,1,Block Group 1; Census Tract 809; Greene County; New York,7,205,212,0,0,0,0,0,7,11,205,212,71,58,49,11,5,7,1995,1996,-666666666,,,,,74853.0,538,36039080900
36,039,080900,2,Block Group 2; Census Tract 809; Greene County; New York,43,284,327,10,0,0,0,0,33,0,284,327,146,48,53,15,22,43,1989,1994,2015,890.0,,2244.0,,70793.0,816,36039080900
36,039,080900,3,Block Group 3; Census Tract 809; Greene County; New York,114,183,297,39,15,4,9,3,44,13,183,297,41,15,68,26,20,114,2005,2011,2017,911.0,1085.0,1237.0,31.2,64205.0,733,36039080900
36,039,080900,4,Block Group 4; Census Tract 809; Greene County; New York,81,174,255,20,0,2,5,26,28,13,174,255,26,15,45,64,11,81,2010,2011,2012,290.0,665.0,740.0,32.9,61458.0,672,36039080900
36,039,080900,5,Block Group 5; Census Tract 809; Greene County; New York,4,391,395,0,0,0,0,4,0,9,391,395,29,76,128,116,33,4,2007,2007,-666666666,,,,,121438.0,1199,36039080900
36,039,081001,1,Block Group 1; Census Tract 810.01; Greene County; New York,132,192,324,28,4,0,8,20,72,30,192,324,25,2,82,47,6,132,2008,2012,2014,776.0,929.0,982.0,21.7,90721.0,945,36039081001
36,039,081001,2,Block Group 2; Census Tract 810.01; Greene County; New York,70,468,538,30,0,0,0,12,28,0,468,538,141,25,160,93,49,70,2004,2006,2017,587.0,783.0,942.0,43.1,35027.0,988,36039081001
36,039,081002,1,Block Group 1; Census Tract 810.02; Greene County; New York,223,194,417,33,38,0,23,22,107,17,194,417,85,0,49,43,0,223,2002,2012,2015,935.0,1057.0,1212.0,27.6,56138.0,718,36039081002
36,039,081002,2,Block Group 2; Census Tract 810.02; Greene County; New York,295,327,622,70,47,0,0,20,158,0,327,622,31,5,113,145,33,295,2011,2014,2016,412.0,789.0,1472.0,25.4,74375.0,1512,36039081002
36,039,081101,1,Block Group 1; Census Tract 811.01; Greene County; New York,148,312,460,10,0,0,0,28,110,0,312,460,177,36,25,34,40,148,1989,2003,2013,710.0,802.0,888.0,13.2,,877,36039081101
36,039,081101,2,Block Group 2; Census Tract 811.01; Greene County; New York,179,411,590,75,0,30,0,0,74,19,411,590,89,0,195,98,10,179,2006,2009,2016,674.0,881.0,1169.0,18.4,55234.0,1718,36039081101
36,039,081101,3,Block Group 3; Census Tract 811.01; Greene County; New York,116,341,457,95,8,13,0,0,0,0,341,457,71,123,84,30,33,116,1998,2003,2019,722.0,744.0,1093.0,45.8,56116.0,920,36039081101
36,039,081101,4,Block Group 4; Census Tract 811.01; Greene County; New York,114,230,344,22,19,0,0,0,73,0,230,344,16,126,24,36,28,114,1998,2010,2016,768.0,881.0,1245.0,46.2,63871.0,740,36039081101
36,039,081102,1,Block Group 1; Census Tract 811.02; Greene County; New York,265,286,551,66,28,4,0,20,147,0,286,551,97,70,47,56,16,265,1997,2011,2016,824.0,874.0,973.0,29.0,64640.0,1612,36039081102
36,039,081102,2,Block Group 2; Census Tract 811.02; Greene County; New York,17,121,138,0,0,0,0,0,17,0,121,138,45,0,27,49,0,17,2006,2009,-666666666,,,,,65625.0,340,36039081102
36,039,081102,3,Block Group 3; Census Tract 811.02; Greene County; New York,64,286,350,35,10,7,0,10,2,0,286,350,81,26,104,54,21,64,2003,2005,2019,1024.0,1072.0,1161.0,44.4,57212.0,981,36039081102
36,071,000100,1,Block Group 1; Census Tract 1; Orange County; New York,119,200,319,70,0,0,13,0,36,60,200,319,21,13,25,41,40,119,2018,2018,2018,823.0,882.0,1095.0,51.0,,615,36071000100
36,071,000100,2,Block Group 2; Census Tract 1; Orange County; New York,117,250,367,101,0,0,0,0,16,0,250,367,53,28,37,99,33,117,2011,2015,-666666666,1077.0,1154.0,1231.0,,103170.0,709,36071000100
36,071,000100,3,Block Group 3; Census Tract 1; Orange County; New York,74,0,74,34,0,0,27,0,13,0,0,74,0,0,0,0,0,74,-666666666,2016,2016,969.0,1303.0,1402.0,51.0,27222.0,748,36071000100
36,071,000100,4,Block Group 4; Census Tract 1; Orange County; New York,384,101,485,37,0,0,13,29,305,0,101,485,18,51,0,32,0,384,1996,2013,2014,1014.0,1144.0,1293.0,51.0,40833.0,1186,36071000100
36,071,000200,1,Block Group 1; Census Tract 2; Orange County; New York,194,436,630,54,10,3,0,27,100,30,436,630,76,35,140,105,50,194,2008,2011,2015,1229.0,1387.0,1589.0,47.8,73750.0,1735,36071000200
36,071,000200,2,Block Group 2; Census Tract 2; Orange County; New York,209,239,448,31,0,2,14,70,92,0,239,448,38,24,119,58,0,209,2005,2008,2012,1110.0,1368.0,1834.0,24.4,107000.0,1340,36071000200
36,071,000301,1,Block Group 1; Census Tract 3.01; Orange County; New York,127,2,129,61,0,0,0,50,16,0,2,129,0,0,2,0,0,127,-666666666,2016,2017,841.0,882.0,937.0,29.2,46161.0,421,36071000301
36,071,000301,2,Block Group 2; Census Tract 3.01; Orange County; New York,401,57,458,227,0,0,19,65,90,0,57,458,0,0,50,7,0,401,-666666666,2018,2018,955.0,1057.0,1227.0,36.7,107922.0,1685,36071000301
36,071,000302,1,Block Group 1; Census Tract 3.02; Orange County; New York,180,154,334,43,0,0,0,58,79,0,154,334,64,0,38,10,42,180,2003,2011,2013,787.0,1082.0,1212.0,31.4,64688.0,1050,36071000302
36,071,000302,2,Block Group 2; Census Tract 3.02; Orange County; New York,365,408,773,119,0,0,14,14,218,0,408,773,80,11,157,128,32,365,2007,2013,2016,821.0,1198.0,1425.0,33.0,62159.0,2656,36071000302
36,071,000302,3,Block Group 3; Census Tract 3.02; Orange County; New York,249,201,450,10,0,0,0,10,229,0,201,450,13,27,83,78,0,249,2007,2012,-666666666,1321.0,1427.0,1616.0,19.2,101705.0,1313,36071000302
36,071,000400,1,Block Group 1; Census Tract 4; Orange County; New York,231,110,341,76,0,0,0,71,84,0,110,341,0,41,61,0,8,231,2002,2010,2014,912.0,962.0,1143.0,51.0,34620.0,914,36071000400
36,071,000400,2,Block Group 2; Census Tract 4; Orange County; New York,447,42,489,164,39,34,61,9,140,0,42,489,0,20,0,6,16,447,2011,2017,2017,781.0,929.0,1160.0,39.8,28967.0,696,36071000400
36,071,000400,3,Block Group 3; Census Tract 4; Orange County; New York,189,125,314,0,0,0,0,0,189,29,125,314,24,72,0,0,0,189,1995,2013,-666666666,765.0,779.0,794.0,26.6,41574.0,914,36071000400
36,071,000400,4,Block Group 4; Census Tract 4; Orange County; New York,210,194,404,119,0,0,0,33,58,0,194,404,15,0,76,84,19,210,2011,2014,2018,271.0,513.0,932.0,46.7,24459.0,1097,36071000400
36,071,000400,5,Block Group 5; Census Tract 4; Orange County; New York,217,65,282,20,0,0,0,0,197,0,65,282,0,0,0,40,25,217,-666666666,2015,2014,1075.0,1151.0,1226.0,45.9,2499.0,1014,36071000400
36,071,000501,1,Block Group 1; Census Tract 5.01; Orange County; New York,226,27,253,0,0,0,72,73,81,0,27,253,0,27,0,0,0,226,-666666666,2004,2006,933.0,972.0,1057.0,17.8,91580.0,1240,36071000501
36,071,000501,2,Block Group 2; Census Tract 5.01; Orange County; New York,542,61,603,32,69,0,0,95,346,0,61,603,0,31,20,10,0,542,2000,2013,2014,574.0,785.0,1158.0,51.0,22670.0,1091,36071000501
36,071,000501,3,Block Group 3; Census Tract 5.01; Orange County; New York,0,94,94,0,0,0,0,0,0,0,94,94,25,0,0,69,0,0,2013,2013,-666666666,849.0,,1507.0,29.7,85676.0,142,36071000501
36,071,000502,1,Block Group 1; Census Tract 5.02; Orange County; New York,252,95,347,147,0,0,0,47,58,0,95,347,0,0,71,24,0,252,2007,2015,2018,1256.0,1338.0,1419.0,37.4,81639.0,1214,36071000502
36,071,000502,2,Block Group 2; Census Tract 5.02; Orange County; New York,309,104,413,37,53,0,0,67,152,0,104,413,45,0,25,16,18,309,2003,2013,2015,895.0,1255.0,1421.0,19.7,93054.0,669,36071000502
36,071,000502,3,Block Group 3; Census Tract 5.02; Orange County; New York,215,74,289,47,0,39,0,6,123,0,74,289,40,18,16,0,0,215,1989,2012,2014,1173.0,1363.0,1621.0,30.7,80404.0,951,36071000502
36,071,000502,4,Block Group 4; Census Tract 5.02; Orange County; New York,258,214,472,58,0,77,0,0,123,21,214,472,0,0,39,101,53,258,2015,2014,2013,942.0,998.0,1607.0,42.5,51622.0,1516,36071000502
36,071,000600,1,Block Group 1; Census Tract 6; Orange County; New York,364,251,615,98,91,10,0,12,153,0,251,615,104,60,38,43,6,364,1994,2013,2018,1308.0,1659.0,1906.0,33.5,57127.0,1736,36071000600
36,071,000600,2,Block Group 2; Census Tract 6; Orange County; New York,780,26,806,11,0,17,59,86,607,0,26,806,26,0,0,0,0,780,-666666666,2013,2013,234.0,,1501.0,28.7,14597.0,1356,36071000600
36,071,000600,3,Block Group 3; Census Tract 6; Orange County; New York,316,0,316,0,0,34,12,0,270,0,0,316,0,0,0,0,0,316,-666666666,2013,2013,1037.0,1115.0,1193.0,51.0,,743,36071000600
36,071,001100,1,Block Group 1; Census Tract 11; Orange County; New York,162,136,298,66,0,0,0,0,96,0,136,298,51,32,10,29,14,162,1995,2014,2017,1571.0,1821.0,2111.0,51.0,73864.0,580,36071001100
36,071,001100,2,Block Group 2; Census Tract 11; Orange County; New York,140,223,363,35,8,0,4,56,37,0,223,363,91,12,20,22,78,140,2004,2010,2012,1037.0,1160.0,1304.0,32.0,,971,36071001100
36,071,001100,3,Block Group 3; Census Tract 11; Orange County; New York,115,324,439,12,0,0,0,0,103,0,324,439,68,32,95,43,86,115,2007,2011,2014,906.0,942.0,979.0,24.4,74761.0,1887,36071001100
36,071,001100,4,Block Group 4; Census Tract 11; Orange County; New York,338,44,382,34,0,10,0,81,213,0,44,382,6,15,23,0,0,338,2000,2012,2013,889.0,1109.0,1316.0,26.3,61967.0,1171,36071001100
36,071,001200,1,Block Group 1; Census Tract 12; Orange County; New York,198,208,406,15,13,8,15,11,136,20,208,406,43,13,72,33,27,198,2007,2012,2014,1287.0,1398.0,1544.0,51.0,47162.0,1175,36071001200
36,071,001200,2,Block Group 2; Census Tract 12; Orange County; New York,140,162,302,35,49,0,0,15,41,0,162,302,5,7,120,13,17,140,2006,2011,2019,909.0,1015.0,1190.0,19.7,95342.0,1430,36071001200
36,071,001300,1,Block Group 1; Census Tract 13; Orange County; New York,82,411,493,29,0,0,8,19,26,70,411,493,71,43,125,69,33,82,2007,2009,2014,1101.0,1302.0,2762.0,26.7,102596.0,1113,36071001300
36,071,001300,2,Block Group 2; Census Tract 13; Orange County; New York,116,637,753,83,16,17,0,0,0,0,637,753,65,79,90,316,87,116,2012,2013,2019,1596.0,1731.0,1865.0,44.0,113750.0,2041,36071001300
36,071,001500,1,Block Group 1; Census Tract 15; Orange County; New York,224,108,332,81,0,0,33,0,110,0,108,332,33,0,48,5,22,224,2004,2014,2016,1100.0,1200.0,1849.0,28.5,63200.0,941,36071001500
36,071,001500,2,Block Group 2; Census Tract 15; Orange County; New York,245,702,947,29,85,0,16,33,82,54,702,947,98,115,269,151,15,245,2005,2008,2017,1210.0,1840.0,2687.0,51.0,69208.0,2799,36071001500
36,071,001500,3,Block Group 3; Census Tract 15; Orange County; New York,454,42,496,119,0,0,13,80,242,0,42,496,0,0,7,35,0,454,2013,2014,2014,,1531.0,1765.0,30.0,58401.0,1317,36071001500
36,071,001601,1,Block Group 1; Census Tract 16.01; Orange County; New York,1119,255,1374,485,275,0,20,73,266,0,255,1374,36,21,58,69,71,1119,2011,2019,2019,1284.0,1583.0,1982.0,41.4,55294.0,2898,36071001601
36,071,001601,2,Block Group 2; Census Tract 16.01; Orange County; New York,39,514,553,11,16,0,0,12,0,24,514,553,55,60,146,100,129,39,2010,2010,2020,1203.0,1367.0,2057.0,37.7,123882.0,1866,36071001601
36,071,001602,1,Block Group 1; Census Tract 16.02; Orange County; New York,89,435,524,23,0,0,0,66,0,17,435,524,160,36,120,56,46,89,2002,2004,2007,,1086.0,1183.0,51.0,67179.0,1961,36071001602
36,071,001602,2,Block Group 2; Census Tract 16.02; Orange County; New York,39,140,179,0,16,0,0,23,0,6,140,179,0,11,84,39,0,39,2007,2007,2008,1135.0,1536.0,1768.0,15.5,99426.0,879,36071001602
36,071,001602,3,Block Group 3; Census Tract 16.02; Orange County; New York,19,203,222,0,0,0,0,0,19,0,203,222,55,58,23,63,4,19,1998,2000,-666666666,,,,,171375.0,515,36071001602
36,071,002100,1,Block Group 1; Census Tract 21; Orange County; New York,118,138,256,0,0,0,10,27,81,0,138,256,16,20,11,91,0,118,2012,2012,2012,769.0,787.0,860.0,51.0,43667.0,686,36071002100
36,071,002100,2,Block Group 2; Census Tract 21; Orange County; New York,173,313,486,23,34,0,0,53,63,0,313,486,106,63,90,54,0,173,1998,2005,2014,853.0,990.0,1298.0,51.0,65679.0,1352,36071002100
36,071,002100,3,Block Group 3; Census Tract 21; Orange County; New York,201,330,531,107,30,0,7,37,20,0,330,531,196,10,28,34,62,201,1989,2008,2019,1069.0,1305.0,1403.0,51.0,,1045,36071002100
36,071,002200,1,Block Group 1; Census Tract 22; Orange County; New York,217,52,269,145,0,0,47,25,0,6,52,269,12,7,11,16,0,217,2006,2018,2019,888.0,1049.0,1208.0,47.0,30216.0,698,36071002200
36,071,002200,2,Block Group 2; Census Tract 22; Orange County; New York,118,196,314,16,25,0,0,22,55,0,196,314,74,33,51,16,22,118,1997,2007,2015,923.0,976.0,1212.0,36.5,65917.0,825,36071002200
36,071,002200,3,Block Group 3; Census Tract 22; Orange County; New York,692,243,935,242,0,0,0,216,234,0,243,935,158,0,37,48,0,692,1989,2012,2014,659.0,804.0,986.0,38.5,32914.0,1758,36071002200
36,071,002300,1,Block Group 1; Census Tract 23; Orange County; New York,113,284,397,41,19,0,0,19,34,8,284,397,121,7,68,60,20,113,2002,2008,2018,1014.0,1285.0,1419.0,51.0,64408.0,1273,36071002300
36,071,002300,2,Block Group 2; Census Tract 23; Orange County; New York,136,191,327,9,0,0,0,0,127,8,191,327,19,13,88,44,19,136,2007,2012,2014,1086.0,1590.0,1795.0,24.5,70875.0,1088,36071002300
36,071,010101,1,Block Group 1; Census Tract 101.01; Orange County; New York,21,622,643,0,0,0,0,0,21,0,622,643,149,27,217,163,66,21,2006,2007,-666666666,,,,,74345.0,2274,36071010101
36,071,010101,2,Block Group 2; Census Tract 101.01; Orange County; New York,51,274,325,19,0,0,0,32,0,0,274,325,36,36,59,120,23,51,2010,2010,2008,1688.0,2102.0,2301.0,51.0,98365.0,1052,36071010101
36,071,010101,3,Block Group 3; Census Tract 101.01; Orange County; New York,89,542,631,21,5,26,0,0,37,0,542,631,76,161,127,100,78,89,2003,2004,2014,1393.0,1555.0,1778.0,45.0,169432.0,2024,36071010101
36,071,010102,1,Block Group 1; Census Tract 101.02; Orange County; New York,267,96,363,66,7,0,0,0,194,0,96,363,8,21,31,20,16,267,2006,2015,2016,1644.0,1820.0,1995.0,26.8,97969.0,1013,36071010102
36,071,010102,2,Block Group 2; Census Tract 101.02; Orange County; New York,66,403,469,16,0,7,0,9,34,14,403,469,26,121,122,92,28,66,2004,2006,2014,780.0,1515.0,1757.0,35.1,130461.0,1278,36071010102
36,071,010102,3,Block Group 3; Census Tract 101.02; Orange County; New York,36,427,463,0,0,0,16,0,20,0,427,463,171,86,91,42,37,36,1995,1996,2011,856.0,1025.0,1138.0,29.5,115313.0,1225,36071010102
36,071,010102,4,Block Group 4; Census Tract 101.02; Orange County; New York,72,255,327,38,0,0,0,0,34,17,255,327,28,5,73,132,0,72,2011,2013,2018,1269.0,1381.0,1494.0,36.3,107171.0,1117,36071010102
36,071,010200,1,Block Group 1; Census Tract 102; Orange County; New York,67,321,388,0,0,0,0,30,37,0,321,388,71,141,62,38,9,67,1996,1999,2011,1325.0,1400.0,1475.0,23.8,107917.0,1254,36071010200
36,071,010200,2,Block Group 2; Census Tract 102; Orange County; New York,85,315,400,0,15,0,0,0,70,10,315,400,64,52,89,85,15,85,2005,2009,2015,1340.0,1483.0,2075.0,19.8,114167.0,1252,36071010200
36,071,010200,3,Block Group 3; Census Tract 102; Orange County; New York,105,443,548,23,16,0,11,33,22,8,443,548,148,0,78,182,27,105,2009,2010,2013,1524.0,1717.0,1910.0,32.3,133611.0,1417,36071010200
36,071,010200,4,Block Group 4; Census Tract 102; Orange County; New York,201,308,509,29,51,0,16,29,76,0,308,509,52,74,80,86,16,201,2004,2010,2016,1227.0,1367.0,1496.0,48.4,98393.0,1578,36071010200
36,071,010300,1,Block Group 1; Census Tract 103; Orange County; New York,34,339,373,0,0,25,0,0,9,0,339,373,97,36,104,102,0,34,2004,2003,-666666666,,,,,83922.0,804,36071010300
36,071,010300,2,Block Group 2; Census Tract 103; Orange County; New York,53,326,379,0,0,0,0,0,53,0,326,379,62,57,173,28,6,53,2003,2004,-666666666,1573.0,1715.0,1858.0,51.0,122656.0,1265,36071010300
36,071,010300,3,Block Group 3; Census Tract 103; Orange County; New York,41,401,442,41,0,0,0,0,0,0,401,442,77,69,25,139,91,41,2012,2013,-666666666,,2234.0,2573.0,34.1,120111.0,1263,36071010300
36,071,010400,1,Block Group 1; Census Tract 104; Orange County; New York,94,284,378,0,0,0,0,94,0,13,284,378,103,57,35,54,22,94,1997,2002,-666666666,,,,,113112.0,1085,36071010400
36,071,010400,2,Block Group 2; Census Tract 104; Orange County; New York,28,233,261,28,0,0,0,0,0,0,233,261,32,40,32,111,18,28,2011,2012,-666666666,1097.0,1194.0,1650.0,23.5,63884.0,789,36071010400
36,071,010400,3,Block Group 3; Census Tract 104; Orange County; New York,461,503,964,61,102,0,12,31,255,0,503,964,212,20,93,142,36,461,2002,2012,2016,1413.0,1640.0,1870.0,30.7,77500.0,2061,36071010400
36,071,010501,1,Block Group 1; Census Tract 105.01; Orange County; New York,116,662,778,0,0,0,0,116,0,0,662,778,155,276,106,72,53,116,1996,1998,-666666666,1342.0,1434.0,2112.0,13.5,71324.0,1895,36071010501
36,071,010501,2,Block Group 2; Census Tract 105.01; Orange County; New York,0,405,405,0,0,0,0,0,0,0,405,405,115,88,154,14,34,0,2000,2000,-666666666,,,,,109702.0,1474,36071010501
36,071,010501,3,Block Group 3; Census Tract 105.01; Orange County; New York,0,304,304,0,0,0,0,0,0,0,304,304,122,0,107,75,0,0,2003,2003,-666666666,,,,,95294.0,864,36071010501
36,071,010502,1,Block Group 1; Census Tract 105.02; Orange County; New York,12,373,385,12,0,0,0,0,0,0,373,385,79,82,110,89,13,12,2002,2003,-666666666,,,,,137743.0,1066,36071010502
36,071,010502,2,Block Group 2; Census Tract 105.02; Orange County; New York,75,479,554,0,0,0,0,0,75,0,479,554,72,33,197,82,95,75,2007,2009,-666666666,,,,,85833.0,1236,36071010502
36,071,010502,3,Block Group 3; Census Tract 105.02; Orange County; New York,50,190,240,0,0,0,0,0,50,10,190,240,76,19,31,54,0,50,2000,2008,-666666666,,,,,101667.0,648,36071010502
36,071,010502,4,Block Group 4; Census Tract 105.02; Orange County; New York,88,605,693,88,0,0,0,0,0,17,605,693,16,26,334,208,4,88,2008,2009,-666666666,1824.0,2135.0,2432.0,25.0,90638.0,1874,36071010502
36,071,010601,1,Block Group 1; Census Tract 106.01; Orange County; New York,29,734,763,0,12,0,0,0,17,9,734,763,70,98,381,137,39,29,2005,2006,-666666666,,,2244.0,34.4,145368.0,2426,36071010601
36,071,010601,2,Block Group 2; Census Tract 106.01; Orange County; New York,33,269,302,0,13,0,20,0,0,0,269,302,77,49,42,59,42,33,2002,2001,-666666666,,,,,110932.0,587,36071010601
36,071,010602,1,Block Group 1; Census Tract 106.02; Orange County; New York,176,471,647,69,18,0,0,40,49,0,471,647,81,36,123,224,7,176,2010,2011,2018,1515.0,1676.0,1838.0,33.9,89922.0,1648,36071010602
36,071,010602,2,Block Group 2; Census Tract 106.02; Orange County; New York,91,228,319,0,47,0,0,0,44,0,228,319,80,37,24,71,16,91,1999,2011,2022,1158.0,1300.0,1419.0,36.8,80114.0,1025,36071010602
36,071,010602,3,Block Group 3; Census Tract 106.02; Orange County; New York,9,275,284,0,9,0,0,0,0,0,275,284,133,52,37,30,23,9,1991,1992,-666666666,,,,,127969.0,804,36071010602
36,071,010701,1,Block Group 1; Census Tract 107.01; Orange County; New York,60,323,383,25,0,0,0,0,35,7,323,383,22,8,147,77,62,60,2009,2011,2017,950.0,1250.0,1750.0,40.0,121614.0,1124,36071010701
36,071,010701,2,Block Group 2; Census Tract 107.01; Orange County; New York,179,276,455,51,16,0,17,0,95,0,276,455,52,33,87,79,25,179,2006,2012,2016,1048.0,1124.0,1201.0,13.5,110938.0,1392,36071010701
36,071,010702,1,Block Group 1; Census Tract 107.02; Orange County; New York,244,182,426,110,0,0,0,0,134,0,182,426,60,69,53,0,0,244,1994,2012,2017,1051.0,1129.0,1208.0,51.0,25714.0,776,36071010702
36,071,010702,2,Block Group 2; Census Tract 107.02; Orange County; New York,86,528,614,0,12,0,0,0,74,107,528,614,116,26,48,36,195,86,2019,2018,2015,1365.0,1629.0,1815.0,25.3,89261.0,1360,36071010702
36,071,010702,3,Block Group 3; Census Tract 107.02; Orange County; New York,286,113,399,75,12,0,0,15,184,84,113,399,0,16,0,13,0,286,2022,2017,2016,853.0,934.0,1194.0,37.9,45934.0,1011,36071010702
36,071,010702,4,Block Group 4; Census Tract 107.02; Orange County; New York,153,304,457,23,0,0,0,0,130,0,304,457,82,69,46,97,10,153,2000,2011,2015,1550.0,1721.0,1892.0,51.0,86314.0,1198,36071010702
36,071,010801,1,Block Group 1; Census Tract 108.01; Orange County; New York,0,236,236,0,0,0,0,0,0,0,236,236,66,0,24,146,0,0,2012,2012,-666666666,,,,,155769.0,1200,36071010801
36,071,010801,2,Block Group 2; Census Tract 108.01; Orange County; New York,462,485,947,42,17,0,13,107,283,0,485,947,122,61,200,61,41,462,2003,2009,2013,763.0,1391.0,1745.0,37.2,94125.0,2159,36071010801
36,071,010801,3,Block Group 3; Census Tract 108.01; Orange County; New York,234,240,474,71,0,0,0,35,128,0,240,474,47,16,36,119,22,234,2011,2013,2015,936.0,1231.0,1478.0,22.4,85707.0,1141,36071010801
36,071,010802,1,Block Group 1; Census Tract 108.02; Orange County; New York,412,387,799,98,11,9,10,28,256,0,387,799,102,27,78,131,49,412,2008,2013,2015,872.0,1296.0,1445.0,34.6,68924.0,1573,36071010802
36,071,010802,2,Block Group 2; Census Tract 108.02; Orange County; New York,26,334,360,24,2,0,0,0,0,5,334,360,114,81,55,64,15,26,1997,1998,2020,,,,,114722.0,1570,36071010802
36,071,010802,3,Block Group 3; Census Tract 108.02; Orange County; New York,33,650,683,9,0,0,0,0,24,80,650,683,156,135,66,123,90,33,2005,2008,2016,1136.0,1288.0,1538.0,18.4,113083.0,2235,36071010802
36,071,010901,1,Block Group 1; Census Tract 109.01; Orange County; New York,95,431,526,46,0,0,2,43,4,0,431,526,61,52,183,102,33,95,2006,2007,2015,1534.0,1695.0,1856.0,48.8,130625.0,1670,36071010901
36,071,010901,2,Block Group 2; Census Tract 109.01; Orange County; New York,391,325,716,68,44,0,29,26,224,24,325,716,63,31,53,58,96,391,2012,2014,2015,920.0,1210.0,1422.0,20.6,95089.0,1790,36071010901
36,071,010902,1,Block Group 1; Census Tract 109.02; Orange County; New York,61,611,672,0,0,0,0,16,45,0,611,672,142,131,130,155,53,61,2003,2004,2013,969.0,1092.0,1523.0,24.8,124798.0,2215,36071010902
36,071,010902,2,Block Group 2; Census Tract 109.02; Orange County; New York,26,366,392,24,0,0,0,0,2,0,366,392,89,7,174,65,31,26,2005,2006,-666666666,718.0,,,51.0,110545.0,1192,36071010902
36,071,010902,3,Block Group 3; Census Tract 109.02; Orange County; New York,4,267,271,0,0,0,0,4,0,0,267,271,13,46,144,22,42,4,2005,2005,-666666666,,,,,156339.0,988,36071010902
36,071,010902,4,Block Group 4; Census Tract 109.02; Orange County; New York,122,318,440,0,0,21,0,10,91,0,318,440,100,15,85,87,31,122,2005,2009,2013,1075.0,2205.0,2414.0,9.0,103611.0,1269,36071010902
36,071,011000,1,Block Group 1; Census Tract 110; Orange County; New York,12,562,574,0,12,0,0,0,0,0,562,574,126,70,222,126,18,12,2004,2004,-666666666,,,,,114887.0,1194,36071011000
36,071,011000,2,Block Group 2; Census Tract 110; Orange County; New York,18,683,701,0,0,12,0,0,6,13,683,701,127,110,182,245,6,18,2006,2006,-666666666,1345.0,1439.0,1631.0,51.0,100781.0,1780,36071011000
36,071,011000,3,Block Group 3; Census Tract 110; Orange County; New York,57,197,254,0,0,0,0,0,57,0,197,254,34,35,118,10,0,57,2003,2005,-666666666,,,,,105132.0,679,36071011000
36,071,011000,4,Block Group 4; Census Tract 110; Orange County; New York,22,223,245,16,0,0,0,0,6,12,223,245,53,11,95,52,0,22,2005,2006,2019,732.0,1263.0,1456.0,12.5,114219.0,865,36071011000
36,071,011000,5,Block Group 5; Census Tract 110; Orange County; New York,34,189,223,0,0,0,0,8,26,0,189,223,8,16,51,65,49,34,2012,2013,2013,,1639.0,1819.0,28.4,63750.0,638,36071011000
36,071,011101,1,Block Group 1; Census Tract 111.01; Orange County; New York,0,267,267,0,0,0,0,0,0,8,267,267,59,82,39,47,32,0,1999,1999,-666666666,,,,,111719.0,824,36071011101
36,071,011101,2,Block Group 2; Census Tract 111.01; Orange County; New York,280,624,904,89,137,0,0,18,36,0,624,904,132,27,267,128,70,280,2006,2010,2021,1301.0,1151.0,1821.0,15.9,90268.0,2799,36071011101
36,071,011102,1,Block Group 1; Census Tract 111.02; Orange County; New York,777,83,860,426,19,0,0,34,298,0,83,860,0,0,83,0,0,777,-666666666,2018,2018,1380.0,1575.0,1797.0,25.1,81250.0,1860,36071011102
36,071,011102,2,Block Group 2; Census Tract 111.02; Orange County; New York,165,324,489,44,12,0,60,0,49,0,324,489,69,65,66,64,60,165,2004,2008,2014,1371.0,1493.0,1904.0,23.0,150347.0,1667,36071011102
36,071,011102,3,Block Group 3; Census Tract 111.02; Orange County; New York,26,350,376,0,0,0,0,0,26,0,350,376,127,63,8,108,44,26,1998,2000,-666666666,781.0,1289.0,1394.0,23.4,101650.0,897,36071011102
36,071,011200,1,Block Group 1; Census Tract 112; Orange County; New York,123,340,463,18,0,0,0,10,95,0,340,463,104,56,65,80,35,123,2002,2010,2014,1025.0,1160.0,2125.0,14.1,74625.0,1227,36071011200
36,071,011200,2,Block Group 2; Census Tract 112; Orange County; New York,96,262,358,17,0,0,0,0,79,0,262,358,22,48,57,33,102,96,2011,2014,2015,913.0,936.0,1375.0,31.5,83289.0,613,36071011200
36,071,011200,3,Block Group 3; Census Tract 112; Orange County; New York,52,299,351,37,0,0,0,0,15,0,299,351,90,19,63,95,32,52,2006,2010,-666666666,,,,,63786.0,1006,36071011200
36,071,011200,4,Block Group 4; Census Tract 112; Orange County; New York,463,340,803,135,17,0,0,31,280,75,340,803,0,5,91,135,34,463,2014,2015,2016,1701.0,1930.0,2228.0,31.6,89263.0,1908,36071011200
36,071,011301,1,Block Group 1; Census Tract 113.01; Orange County; New York,41,497,538,0,0,0,0,0,41,0,497,538,0,0,93,386,18,41,2013,2013,-666666666,,,,,79479.0,1410,36071011301
36,071,011301,2,Block Group 2; Census Tract 113.01; Orange County; New York,813,131,944,396,0,0,87,111,219,0,131,944,52,0,53,0,26,813,2003,2016,2018,950.0,1229.0,1502.0,33.5,54479.0,2749,36071011301
36,071,011301,3,Block Group 3; Census Tract 113.01; Orange County; New York,66,301,367,31,0,0,0,0,35,0,301,367,42,94,93,18,54,66,2002,2005,-666666666,1116.0,1279.0,1451.0,51.0,65813.0,732,36071011301
36,071,011302,1,Block Group 1; Census Tract 113.02; Orange County; New York,288,320,608,161,0,0,0,11,116,41,320,608,18,82,126,15,38,288,2005,2014,2018,1167.0,1334.0,1424.0,27.8,85375.0,1387,36071011302
36,071,011302,2,Block Group 2; Census Tract 113.02; Orange County; New York,334,89,423,100,39,0,17,25,153,0,89,423,6,0,31,52,0,334,2011,2015,2017,1056.0,1311.0,1699.0,24.0,69323.0,909,36071011302
36,071,011302,3,Block Group 3; Census Tract 113.02; Orange County; New York,260,204,464,81,0,0,0,43,136,0,204,464,0,5,143,25,31,260,2007,2012,2015,1065.0,1169.0,1594.0,43.6,83611.0,1016,36071011302
36,071,011400,1,Block Group 1; Census Tract 114; Orange County; New York,27,713,740,0,0,0,0,0,27,15,713,740,171,117,207,175,28,27,2003,2004,-666666666,1518.0,1679.0,1839.0,18.4,101250.0,2282,36071011400
36,071,011400,2,Block Group 2; Census Tract 114; Orange County; New York,36,254,290,0,0,0,0,13,23,10,254,290,31,59,130,19,5,36,2003,2004,-666666666,,,,,107708.0,798,36071011400
36,071,011400,3,Block Group 3; Census Tract 114; Orange County; New York,12,529,541,0,0,12,0,0,0,37,529,541,78,81,111,136,86,12,2010,2009,-666666666,,,,,99479.0,1333,36071011400
36,071,011500,1,Block Group 1; Census Tract 115; Orange County; New York,0,45,45,0,0,0,0,0,0,0,45,45,0,13,0,32,0,0,2012,2012,-666666666,,,,,58365.0,1138,36071011500
36,071,011500,2,Block Group 2; Census Tract 115; Orange County; New York,43,515,558,0,0,0,0,0,43,0,515,558,81,249,67,74,44,43,1997,1998,-666666666,,,,,102404.0,1308,36071011500
36,071,011500,3,Block Group 3; Census Tract 115; Orange County; New York,0,284,284,0,0,0,0,0,0,13,284,284,69,22,95,53,32,0,2005,2005,-666666666,,,,,118462.0,757,36071011500
36,071,011500,4,Block Group 4; Census Tract 115; Orange County; New York,21,313,334,0,13,0,0,0,8,55,313,334,72,43,60,51,32,21,2007,2009,-666666666,1426.0,1613.0,1806.0,20.4,124182.0,1172,36071011500
36,071,011500,5,Block Group 5; Census Tract 115; Orange County; New York,356,531,887,35,11,10,0,53,247,29,531,887,77,110,131,148,36,356,2006,2011,2014,676.0,785.0,1192.0,29.1,70037.0,2174,36071011500
36,071,011601,1,Block Group 1; Census Tract 116.01; Orange County; New York,112,369,481,73,0,0,0,19,20,18,369,481,36,109,91,73,42,112,2004,2009,2019,1365.0,1523.0,1841.0,19.4,92083.0,1435,36071011601
36,071,011601,2,Block Group 2; Census Tract 116.01; Orange County; New York,207,432,639,115,0,11,5,22,54,0,432,639,86,43,78,186,39,207,2010,2012,2018,815.0,1006.0,1612.0,45.1,53257.0,1703,36071011601
36,071,011601,3,Block Group 3; Census Tract 116.01; Orange County; New York,57,186,243,45,0,0,0,12,0,27,186,243,59,8,56,24,12,57,2005,2008,-666666666,,,,,77880.0,558,36071011601
36,071,011602,1,Block Group 1; Census Tract 116.02; Orange County; New York,50,175,225,50,0,0,0,0,0,0,175,225,90,39,35,0,11,50,1989,1996,-666666666,960.0,1034.0,1142.0,29.3,72159.0,517,36071011602
36,071,011602,2,Block Group 2; Census Tract 116.02; Orange County; New York,54,258,312,35,0,0,0,9,10,9,258,312,9,42,137,20,41,54,2006,2007,2019,1273.0,1348.0,1424.0,17.9,107188.0,1040,36071011602
36,071,011602,3,Block Group 3; Census Tract 116.02; Orange County; New York,197,346,543,98,14,0,10,8,67,32,346,543,77,79,68,74,16,197,2003,2012,2018,959.0,1051.0,1167.0,51.0,69554.0,1266,36071011602
36,071,011602,4,Block Group 4; Census Tract 116.02; Orange County; New York,82,351,433,14,0,7,24,0,37,11,351,433,56,68,103,83,30,82,2005,2006,2012,588.0,927.0,982.0,15.6,62875.0,979,36071011602
36,071,011701,1,Block Group 1; Census Tract 117.01; Orange County; New York,43,572,615,28,15,0,0,0,0,0,572,615,128,87,77,152,128,43,2009,2011,-666666666,,,,,130139.0,1936,36071011701
36,071,011701,2,Block Group 2; Census Tract 117.01; Orange County; New York,178,512,690,33,0,0,0,0,145,12,512,690,88,63,142,98,109,178,2007,2012,2015,857.0,1083.0,1647.0,27.5,136250.0,2124,36071011701
36,071,011701,3,Block Group 3; Census Tract 117.01; Orange County; New York,47,217,264,0,35,0,0,0,12,0,217,264,43,48,30,64,32,47,2006,2011,2022,,,,,92174.0,621,36071011701
36,071,011702,1,Block Group 1; Census Tract 117.02; Orange County; New York,32,515,547,0,0,0,0,32,0,8,515,547,104,42,121,142,98,32,2009,2008,-666666666,,,,,133203.0,1667,36071011702
36,071,011702,2,Block Group 2; Census Tract 117.02; Orange County; New York,114,424,538,51,0,0,0,0,63,13,424,538,30,37,133,142,69,114,2011,2013,2017,1320.0,1469.0,2604.0,14.6,121471.0,1819,36071011702
36,071,011702,3,Block Group 3; Census Tract 117.02; Orange County; New York,123,271,394,32,0,0,0,50,41,6,271,394,52,40,119,23,31,123,2004,2006,2012,1151.0,1292.0,1412.0,22.9,85833.0,1147,36071011702
36,071,011801,1,Block Group 1; Census Tract 118.01; Orange County; New York,63,673,736,12,0,0,0,0,51,0,673,736,154,124,211,132,52,63,2003,2004,2015,1469.0,1650.0,1825.0,42.5,127315.0,1974,36071011801
36,071,011801,2,Block Group 2; Census Tract 118.01; Orange County; New York,48,118,166,48,0,0,0,0,0,0,118,166,60,29,0,18,11,48,1989,1998,-666666666,,,,,134076.0,460,36071011801
36,071,011801,3,Block Group 3; Census Tract 118.01; Orange County; New York,89,766,855,28,49,0,0,0,12,11,766,855,46,117,243,252,97,89,2009,2011,2022,1267.0,1359.0,1450.0,51.0,152054.0,2695,36071011801
36,071,011802,1,Block Group 1; Census Tract 118.02; Orange County; New York,29,332,361,0,7,6,0,0,16,14,332,361,48,41,98,125,6,29,2008,2009,2014,763.0,1589.0,1795.0,22.5,119583.0,1051,36071011802
36,071,011802,2,Block Group 2; Census Tract 118.02; Orange County; New York,30,495,525,24,0,0,0,6,0,29,495,525,131,109,142,75,9,30,2001,2002,2019,,,,,97321.0,1302,36071011802
36,071,011900,1,Block Group 1; Census Tract 119; Orange County; New York,39,412,451,39,0,0,0,0,0,0,412,451,81,8,139,133,51,39,2008,2010,-666666666,,,,,234712.0,1697,36071011900
36,071,011900,2,Block Group 2; Census Tract 119; Orange County; New York,24,583,607,6,0,0,0,0,18,25,583,607,186,97,114,135,26,24,2001,2002,-666666666,,,,,123681.0,1468,36071011900
36,071,011900,3,Block Group 3; Census Tract 119; Orange County; New York,68,0,68,53,0,0,0,0,15,0,0,68,0,0,0,0,0,68,-666666666,2019,2019,1009.0,1090.0,1170.0,51.0,24306.0,390,36071011900
36,071,011900,4,Block Group 4; Census Tract 119; Orange County; New York,0,13,13,0,0,0,0,0,0,0,13,13,0,0,6,0,7,0,-666666666,-666666666,-666666666,,,,,,507,36071011900
36,071,011900,5,Block Group 5; Census Tract 119; Orange County; New York,59,559,618,8,12,0,0,0,39,12,559,618,84,87,134,188,54,59,2008,2010,2016,,,,14.9,171488.0,2659,36071011900
36,071,012100,1,Block Group 1; Census Tract 121; Orange County; New York,135,182,317,6,0,0,0,7,122,9,182,317,54,25,49,38,7,135,2002,2011,2014,1307.0,1437.0,1669.0,51.0,108977.0,911,36071012100
36,071,012100,2,Block Group 2; Census Tract 121; Orange County; New York,238,144,382,89,0,0,0,63,86,0,144,382,0,10,100,34,0,238,2006,2011,2015,892.0,1398.0,2234.0,23.8,90227.0,1083,36071012100
36,071,012100,3,Block Group 3; Census Tract 121; Orange County; New York,20,308,328,0,0,0,0,0,20,9,308,328,131,99,7,32,30,20,1992,1993,-666666666,,,,,83500.0,1034,36071012100
36,071,012100,4,Block Group 4; Census Tract 121; Orange County; New York,251,119,370,33,48,0,0,69,101,0,119,370,12,49,35,23,0,251,2000,2011,2014,908.0,992.0,1276.0,34.8,69667.0,805,36071012100
36,071,012200,1,Block Group 1; Census Tract 122; Orange County; New York,10,758,768,0,0,0,0,10,0,10,758,768,244,176,148,143,37,10,1998,1998,-666666666,,,,,79500.0,1806,36071012200
36,071,012200,2,Block Group 2; Census Tract 122; Orange County; New York,154,328,482,61,0,0,15,0,78,24,328,482,63,55,43,130,13,154,2010,2013,2016,1096.0,1491.0,1835.0,47.9,100962.0,1131,36071012200
36,071,012200,3,Block Group 3; Census Tract 122; Orange County; New York,20,274,294,14,0,0,6,0,0,0,274,294,52,27,50,109,36,20,2011,2011,-666666666,,,,,124706.0,1002,36071012200
36,071,012300,1,Block Group 1; Census Tract 123; Orange County; New York,23,260,283,0,0,0,0,23,0,0,260,283,19,5,63,161,12,23,2012,2012,-666666666,,,,,94750.0,957,36071012300
36,071,012300,2,Block Group 2; Census Tract 123; Orange County; New York,85,625,710,85,0,0,0,0,0,40,625,710,99,216,112,98,60,85,2000,2004,-666666666,845.0,890.0,1360.0,24.4,142885.0,2154,36071012300
36,071,012300,3,Block Group 3; Census Tract 123; Orange County; New York,36,290,326,8,0,0,0,0,28,30,290,326,49,88,88,35,0,36,2001,2003,-666666666,,,,,93750.0,1057,36071012300
36,071,012300,4,Block Group 4; Census Tract 123; Orange County; New York,8,366,374,0,0,0,0,0,8,0,366,374,96,59,121,76,14,8,2002,2003,-666666666,,,,,116250.0,1284,36071012300
36,071,012601,1,Block Group 1; Census Tract 126.01; Orange County; New York,291,501,792,0,0,0,0,123,168,39,501,792,114,29,154,145,20,291,2007,2009,2011,580.0,922.0,2122.0,32.8,115862.0,2176,36071012601
36,071,012601,2,Block Group 2; Census Tract 126.01; Orange County; New York,252,836,1088,55,33,0,0,13,151,40,836,1088,77,183,179,234,123,252,2009,2012,2016,944.0,1195.0,1727.0,26.3,100313.0,2630,36071012601
36,071,012602,1,Block Group 1; Census Tract 126.02; Orange County; New York,53,390,443,37,0,0,0,0,16,28,390,443,26,73,174,89,0,53,2006,2007,2019,1095.0,1189.0,1632.0,21.6,82153.0,990,36071012602
36,071,012602,2,Block Group 2; Census Tract 126.02; Orange County; New York,259,74,333,54,0,0,0,65,140,0,74,333,0,8,28,38,0,259,2010,2013,2014,1376.0,1563.0,1866.0,20.4,103844.0,993,36071012602
36,071,012602,3,Block Group 3; Census Tract 126.02; Orange County; New York,304,220,524,135,55,0,4,0,110,0,220,524,49,0,54,111,6,304,2011,2016,2019,1058.0,1201.0,1651.0,43.2,58561.0,898,36071012602
36,071,012700,1,Block Group 1; Census Tract 127; Orange County; New York,27,244,271,0,0,0,0,13,14,0,244,271,45,35,32,66,66,27,2011,2011,-666666666,,,,,151250.0,831,36071012700
36,071,012700,2,Block Group 2; Census Tract 127; Orange County; New York,115,115,230,0,0,0,21,14,80,0,115,230,52,24,16,10,13,115,1992,2006,2012,835.0,954.0,1112.0,51.0,71731.0,712,36071012700
36,071,012700,3,Block Group 3; Census Tract 127; Orange County; New York,24,186,210,0,8,2,0,8,6,9,186,210,95,23,6,39,14,24,1989,1993,2013,969.0,1344.0,2042.0,23.4,96111.0,472,36071012700
36,071,012700,4,Block Group 4; Census Tract 127; Orange County; New York,91,263,354,70,0,0,0,0,21,0,263,354,40,21,78,120,4,91,2009,2012,2019,1271.0,1449.0,2108.0,30.9,78910.0,1031,36071012700
36,071,012700,5,Block Group 5; Census Tract 127; Orange County; New York,328,101,429,112,48,0,3,0,165,0,101,429,39,16,16,3,27,328,1997,2017,2018,1325.0,1488.0,1785.0,29.2,84886.0,871,36071012700
36,071,012800,1,Block Group 1; Census Tract 128; Orange County; New York,0,247,247,0,0,0,0,0,0,0,247,247,54,22,76,79,16,0,2006,2006,-666666666,,,,,106493.0,873,36071012800
36,071,012800,2,Block Group 2; Census Tract 128; Orange County; New York,43,590,633,0,0,0,0,36,7,79,590,633,54,97,204,96,60,43,2007,2007,2006,721.0,741.0,1156.0,51.0,66594.0,1471,36071012800
36,071,012800,3,Block Group 3; Census Tract 128; Orange County; New York,0,215,215,0,0,0,0,0,0,0,215,215,42,41,51,68,13,0,2005,2005,-666666666,,,,,185483.0,571,36071012800
36,071,012800,4,Block Group 4; Census Tract 128; Orange County; New York,225,266,491,55,0,0,0,65,105,0,266,491,58,39,51,105,13,225,2007,2011,2014,1049.0,1168.0,1393.0,39.9,80867.0,1375,36071012800
36,071,012800,5,Block Group 5; Census Tract 128; Orange County; New York,101,198,299,38,0,0,0,0,63,25,198,299,0,19,46,60,48,101,2015,2015,2016,1391.0,1750.0,2532.0,39.0,68281.0,610,36071012800
36,071,012900,1,Block Group 1; Census Tract 129; Orange County; New York,120,283,403,63,0,0,0,6,51,5,283,403,106,40,59,63,10,120,1999,2009,2018,957.0,1339.0,1784.0,19.1,130625.0,955,36071012900
36,071,012900,2,Block Group 2; Census Tract 129; Orange County; New York,123,258,381,0,8,14,20,16,65,0,258,381,72,17,78,23,68,123,2005,2007,2011,1058.0,1222.0,1375.0,21.8,87188.0,966,36071012900
36,071,012900,3,Block Group 3; Census Tract 129; Orange County; New York,105,355,460,30,0,0,14,0,61,0,355,460,68,49,58,154,26,105,2010,2012,2015,1105.0,1315.0,1477.0,22.6,114000.0,1154,36071012900
36,071,013000,1,Block Group 1; Census Tract 130; Orange County; New York,113,292,405,9,6,0,0,10,88,0,292,405,110,61,67,22,32,113,1996,2004,2014,1717.0,2037.0,2268.0,28.0,110598.0,1385,36071013000
36,071,013000,2,Block Group 2; Census Tract 130; Orange County; New York,50,270,320,10,0,0,0,10,30,0,270,320,68,52,31,47,72,50,2005,2010,2014,1033.0,1197.0,1702.0,51.0,90882.0,806,36071013000
36,071,013000,3,Block Group 3; Census Tract 130; Orange County; New York,214,252,466,66,0,0,30,8,110,12,252,466,11,46,106,66,11,214,2007,2011,2015,1167.0,1531.0,1765.0,22.1,92397.0,1216,36071013000
36,071,013000,4,Block Group 4; Census Tract 130; Orange County; New York,221,266,487,51,0,0,0,10,160,0,266,487,63,28,55,70,50,221,2008,2013,2015,1150.0,1330.0,1718.0,26.2,74760.0,1004,36071013000
36,071,013100,1,Block Group 1; Census Tract 131; Orange County; New York,8,292,300,0,0,0,0,8,0,0,292,300,43,31,36,80,102,8,2014,2013,-666666666,,,,,146154.0,1258,36071013100
36,071,013100,2,Block Group 2; Census Tract 131; Orange County; New York,19,386,405,10,0,0,0,0,9,25,386,405,76,11,86,132,56,19,2011,2012,-666666666,,,,,182056.0,1045,36071013100
36,071,013100,3,Block Group 3; Census Tract 131; Orange County; New York,53,477,530,0,0,0,0,10,43,0,477,530,162,79,150,71,15,53,2000,2002,-666666666,,,,,168750.0,1626,36071013100
36,071,013100,4,Block Group 4; Census Tract 131; Orange County; New York,31,157,188,0,0,0,0,0,31,0,157,188,9,35,51,35,27,31,2007,2010,-666666666,,,,,113629.0,435,36071013100
36,071,013100,5,Block Group 5; Census Tract 131; Orange County; New York,255,223,478,15,47,0,23,39,131,0,223,478,44,36,60,36,47,255,2005,2012,2014,1131.0,1586.0,1793.0,44.7,96755.0,968,36071013100
36,071,013201,1,Block Group 1; Census Tract 132.01; Orange County; New York,39,264,303,0,12,0,0,0,27,0,264,303,55,21,22,78,88,39,2013,2014,2016,1203.0,1639.0,1819.0,24.9,104280.0,928,36071013201
36,071,013201,2,Block Group 2; Census Tract 132.01; Orange County; New York,30,137,167,20,0,0,10,0,0,0,137,167,47,28,41,13,8,30,1998,2000,-666666666,,,,,185298.0,477,36071013201
36,071,013201,3,Block Group 3; Census Tract 132.01; Orange County; New York,300,322,622,147,0,0,0,68,85,5,322,622,31,12,119,92,63,300,2010,2014,2018,798.0,1009.0,1352.0,38.8,55152.0,1343,36071013201
36,071,013201,4,Block Group 4; Census Tract 132.01; Orange County; New York,14,716,730,0,0,0,0,0,14,46,716,730,103,181,193,154,39,14,2004,2004,-666666666,,,,,160000.0,2517,36071013201
36,071,013202,1,Block Group 1; Census Tract 132.02; Orange County; New York,31,368,399,0,0,0,0,4,27,0,368,399,57,62,89,108,52,31,2007,2009,2013,997.0,1592.0,1796.0,18.0,96103.0,1090,36071013202
36,071,013202,2,Block Group 2; Census Tract 132.02; Orange County; New York,41,286,327,12,10,0,0,0,19,0,286,327,25,33,144,37,47,41,2006,2007,2018,1296.0,1408.0,1575.0,32.5,107031.0,987,36071013202
36,071,013301,1,Block Group 1; Census Tract 133.01; Orange County; New York,94,593,687,41,0,0,0,0,53,8,593,687,87,99,152,92,155,94,2007,2010,2017,1135.0,2000.0,2250.0,28.9,114095.0,2613,36071013301
36,071,013301,2,Block Group 2; Census Tract 133.01; Orange County; New York,20,482,502,0,0,0,0,20,0,53,482,502,35,13,79,129,173,20,2017,2016,-666666666,,,,,58064.0,1613,36071013301
36,071,013301,3,Block Group 3; Census Tract 133.01; Orange County; New York,136,213,349,91,0,45,0,0,0,17,213,349,10,7,76,103,0,136,2011,2013,2019,1325.0,1534.0,1822.0,21.9,97539.0,929,36071013301
36,071,013302,1,Block Group 1; Census Tract 133.02; Orange County; New York,0,406,406,0,0,0,0,0,0,19,406,406,80,37,111,79,80,0,2008,2008,-666666666,,,,,131944.0,1044,36071013302
36,071,013302,2,Block Group 2; Census Tract 133.02; Orange County; New York,41,256,297,21,0,0,0,20,0,0,256,297,35,29,127,17,48,41,2005,2006,-666666666,,,,,116378.0,1169,36071013302
36,071,013400,1,Block Group 1; Census Tract 134; Orange County; New York,138,213,351,48,20,0,11,7,52,0,213,351,31,68,29,10,75,138,2003,2014,2018,1352.0,1537.0,2153.0,26.0,59087.0,604,36071013400
36,071,013400,2,Block Group 2; Census Tract 134; Orange County; New York,115,121,236,55,0,11,0,0,49,0,121,236,71,34,12,0,4,115,1989,2002,2018,1256.0,1435.0,1831.0,14.2,100192.0,441,36071013400
36,071,013400,3,Block Group 3; Census Tract 134; Orange County; New York,117,459,576,13,33,0,0,0,71,0,459,576,123,46,77,131,82,117,2008,2012,2017,1317.0,1602.0,2268.0,51.0,57656.0,2920,36071013400
36,071,013500,1,Block Group 1; Census Tract 135; Orange County; New York,50,566,616,50,0,0,0,0,0,0,566,616,86,20,226,218,16,50,2008,2009,-666666666,,,,,155122.0,1989,36071013500
36,071,013500,2,Block Group 2; Census Tract 135; Orange County; New York,14,673,687,14,0,0,0,0,0,0,673,687,69,117,253,234,0,14,2006,2006,-666666666,,,,,182809.0,2583,36071013500
36,071,013500,3,Block Group 3; Census Tract 135; Orange County; New York,71,628,699,0,0,0,0,0,71,0,628,699,47,99,137,316,29,71,2011,2011,-666666666,1113.0,1226.0,1720.0,20.5,79493.0,1666,36071013500
36,071,013600,1,Block Group 1; Census Tract 136; Orange County; New York,1063,0,1063,568,86,0,0,9,400,0,0,1063,0,0,0,0,0,1063,-666666666,2019,2019,2925.0,3382.0,3501.0,31.5,133844.0,6386,36071013600
36,071,013800,1,Block Group 1; Census Tract 138; Orange County; New York,190,153,343,77,9,0,23,33,48,13,153,343,11,0,23,106,0,190,2013,2014,2017,1146.0,1391.0,1994.0,28.0,101354.0,580,36071013800
36,071,013800,2,Block Group 2; Census Tract 138; Orange County; New York,348,377,725,112,11,99,0,56,70,44,377,725,50,60,150,55,18,348,2005,2007,2012,1099.0,1390.0,2211.0,24.6,83875.0,1986,36071013800
36,071,013800,3,Block Group 3; Census Tract 138; Orange County; New York,128,352,480,13,42,30,0,0,43,15,352,480,73,64,98,35,67,128,2004,2007,2016,635.0,1321.0,1467.0,21.4,91000.0,1136,36071013800
36,071,013900,1,Block Group 1; Census Tract 139; Orange County; New York,0,264,264,0,0,0,0,0,0,23,264,264,97,10,41,58,35,0,2006,2006,-666666666,,,,,135500.0,764,36071013900
36,071,013900,2,Block Group 2; Census Tract 139; Orange County; New York,14,110,124,0,0,0,0,14,0,0,110,124,17,44,39,0,10,14,1999,2000,-666666666,,,,,146136.0,430,36071013900
36,071,013900,3,Block Group 3; Census Tract 139; Orange County; New York,70,312,382,44,0,0,0,0,26,17,312,382,89,30,71,85,20,70,2005,2010,2019,1378.0,1511.0,1756.0,34.8,127750.0,1445,36071013900
36,071,013900,4,Block Group 4; Census Tract 139; Orange County; New York,42,703,745,0,0,0,0,13,29,12,703,745,56,184,324,97,30,42,2003,2004,-666666666,1685.0,1870.0,3114.0,13.7,149650.0,2494,36071013900
36,071,014101,1,Block Group 1; Census Tract 141.01; Orange County; New York,103,172,275,21,32,0,0,19,31,0,172,275,28,28,9,107,0,103,2012,2013,2018,983.0,1125.0,1585.0,25.4,90425.0,1100,36071014101
36,071,014101,2,Block Group 2; Census Tract 141.01; Orange County; New York,170,282,452,39,22,0,0,29,80,0,282,452,14,39,37,145,47,170,2013,2014,2016,1292.0,1393.0,1494.0,41.1,109667.0,1597,36071014101
36,071,014101,3,Block Group 3; Census Tract 141.01; Orange County; New York,21,761,782,0,0,0,0,13,8,32,761,782,73,184,224,65,183,21,2006,2006,-666666666,,,,,116053.0,2159,36071014101
36,071,014102,1,Block Group 1; Census Tract 141.02; Orange County; New York,258,265,523,68,22,16,8,0,144,0,265,523,34,15,113,19,84,258,2007,2014,2016,1647.0,1795.0,1942.0,26.0,100257.0,1624,36071014102
36,071,014102,2,Block Group 2; Census Tract 141.02; Orange County; New York,170,218,388,36,0,0,3,101,30,0,218,388,13,64,59,69,13,170,2005,2007,2008,1400.0,1579.0,1790.0,24.1,101337.0,1101,36071014102
36,071,014102,3,Block Group 3; Census Tract 141.02; Orange County; New York,287,226,513,129,27,0,0,0,131,0,226,513,16,10,81,55,64,287,2011,2016,2018,1571.0,1726.0,1880.0,24.0,99861.0,1114,36071014102
36,071,014102,4,Block Group 4; Census Tract 141.02; Orange County; New York,170,465,635,20,0,0,0,29,121,13,465,635,153,61,146,84,8,170,2001,2006,2014,940.0,1183.0,2244.0,38.9,72083.0,1829,36071014102
36,071,014201,1,Block Group 1; Census Tract 142.01; Orange County; New York,12,363,375,0,0,0,0,3,9,0,363,375,113,146,49,18,37,12,1995,1995,-666666666,,,,,96488.0,958,36071014201
36,071,014201,2,Block Group 2; Census Tract 142.01; Orange County; New York,0,252,252,0,0,0,0,0,0,0,252,252,75,50,35,86,6,0,2000,2000,-666666666,,,,,185286.0,785,36071014201
36,071,014201,3,Block Group 3; Census Tract 142.01; Orange County; New York,119,575,694,0,0,0,0,0,119,15,575,694,82,85,299,87,7,119,2004,2006,-666666666,1356.0,1463.0,1696.0,51.0,120306.0,2008,36071014201
36,071,014202,1,Block Group 1; Census Tract 142.02; Orange County; New York,0,272,272,0,0,0,0,0,0,0,272,272,44,90,100,38,0,0,2000,2000,-666666666,,,,,250001.0,918,36071014202
36,071,014202,2,Block Group 2; Census Tract 142.02; Orange County; New York,20,569,589,0,0,0,0,0,20,0,569,589,78,66,279,146,0,20,2005,2005,-666666666,,,,,129327.0,1873,36071014202
36,071,014202,3,Block Group 3; Census Tract 142.02; Orange County; New York,5,452,457,0,0,5,0,0,0,0,452,457,103,35,121,94,99,5,2007,2007,-666666666,,,,,135288.0,1285,36071014202
36,071,014202,4,Block Group 4; Census Tract 142.02; Orange County; New York,52,325,377,0,0,0,0,0,52,19,325,377,26,0,80,163,37,52,2013,2013,-666666666,,,,,202697.0,1272,36071014202
36,071,014202,5,Block Group 5; Census Tract 142.02; Orange County; New York,0,422,422,0,0,0,0,0,0,0,422,422,166,135,46,75,0,0,1993,1993,-666666666,,,,,162802.0,1377,36071014202
36,071,014301,1,Block Group 1; Census Tract 143.01; Orange County; New York,100,229,329,0,0,0,0,14,86,61,229,329,96,9,50,13,0,100,2002,2009,2013,,1105.0,1193.0,51.0,,783,36071014301
36,071,014301,2,Block Group 2; Census Tract 143.01; Orange County; New York,383,185,568,170,43,0,0,38,132,0,185,568,64,55,59,7,0,383,1995,2014,2018,966.0,1143.0,1538.0,18.5,112091.0,1307,36071014301
36,071,014301,3,Block Group 3; Census Tract 143.01; Orange County; New York,0,288,288,0,0,0,0,0,0,0,288,288,105,13,81,49,40,0,2003,2003,-666666666,,,,,113491.0,872,36071014301
36,071,014301,4,Block Group 4; Census Tract 143.01; Orange County; New York,240,357,597,63,11,0,0,87,79,0,357,597,45,61,94,143,14,240,2008,2010,2013,1590.0,1769.0,1949.0,19.2,100329.0,1572,36071014301
36,071,014302,1,Block Group 1; Census Tract 143.02; Orange County; New York,35,540,575,0,0,0,0,0,35,19,540,575,32,76,71,225,117,35,2013,2013,-666666666,,,,,149779.0,1862,36071014302
36,071,014302,2,Block Group 2; Census Tract 143.02; Orange County; New York,0,1044,1044,0,0,0,0,0,0,55,1044,1044,132,266,298,259,34,0,2004,2004,-666666666,,,,,181091.0,2979,36071014302
36,071,014302,3,Block Group 3; Census Tract 143.02; Orange County; New York,16,384,400,0,0,0,16,0,0,18,384,400,101,14,32,186,33,16,2012,2012,-666666666,,,,,142102.0,1103,36071014302
36,071,014302,4,Block Group 4; Census Tract 143.02; Orange County; New York,85,505,590,28,0,0,0,0,57,0,505,590,86,85,222,91,21,85,2004,2006,-666666666,,,,,161711.0,2113,36071014302
36,071,014400,1,Block Group 1; Census Tract 144; Orange County; New York,81,249,330,25,11,0,0,2,43,0,249,330,76,23,36,86,28,81,2007,2012,2017,1123.0,1431.0,1734.0,31.3,96776.0,775,36071014400
36,071,014400,2,Block Group 2; Census Tract 144; Orange County; New York,38,463,501,7,0,12,0,0,19,0,463,501,99,31,229,93,11,38,2004,2005,2013,813.0,1684.0,1934.0,32.5,123194.0,1449,36071014400
36,071,014400,3,Block Group 3; Census Tract 144; Orange County; New York,63,246,309,35,0,0,0,4,24,0,246,309,31,72,18,93,32,63,2010,2012,2018,1429.0,1616.0,1808.0,31.3,99688.0,972,36071014400
36,071,014400,4,Block Group 4; Census Tract 144; Orange County; New York,39,441,480,16,0,0,0,3,20,0,441,480,72,77,189,74,29,39,2004,2005,2017,1131.0,1625.0,2213.0,16.5,132357.0,1680,36071014400
36,071,014501,1,Block Group 1; Census Tract 145.01; Orange County; New York,66,418,484,51,0,0,8,0,7,0,418,484,64,24,157,108,65,66,2008,2009,2019,1383.0,1629.0,1864.0,22.5,148500.0,1386,36071014501
36,071,014501,2,Block Group 2; Census Tract 145.01; Orange County; New York,0,449,449,0,0,0,0,0,0,0,449,449,149,50,113,81,56,0,2002,2002,-666666666,,,,,149653.0,1462,36071014501
36,071,014501,3,Block Group 3; Census Tract 145.01; Orange County; New York,93,502,595,0,0,11,0,20,62,0,502,595,111,106,114,124,47,93,2003,2005,2012,,,,,109223.0,1456,36071014501
36,071,014502,1,Block Group 1; Census Tract 145.02; Orange County; New York,366,510,876,0,0,0,0,19,347,22,510,876,50,17,137,272,12,366,2012,2013,2014,888.0,1086.0,1176.0,46.9,,2037,36071014502
36,071,014502,2,Block Group 2; Census Tract 145.02; Orange County; New York,15,399,414,0,0,0,0,0,15,24,399,414,54,142,153,26,0,15,2000,2001,-666666666,,,,,161125.0,1432,36071014502
36,071,014502,3,Block Group 3; Census Tract 145.02; Orange County; New York,205,651,856,91,0,0,35,0,79,21,651,856,91,176,137,128,98,205,2004,2009,2017,1217.0,1649.0,1824.0,9.0,210882.0,2464,36071014502
36,071,014601,1,Block Group 1; Census Tract 146.01; Orange County; New York,375,247,622,131,39,0,0,30,175,21,247,622,84,0,85,32,25,375,2005,2014,2017,599.0,1011.0,1357.0,31.7,48068.0,780,36071014601
36,071,014601,2,Block Group 2; Census Tract 146.01; Orange County; New York,16,246,262,0,0,0,0,0,16,0,246,262,10,75,97,39,25,16,2004,2005,-666666666,,,,,129384.0,779,36071014601
36,071,014601,3,Block Group 3; Census Tract 146.01; Orange County; New York,154,283,437,55,10,0,0,9,80,10,283,437,19,5,86,117,46,154,2012,2014,2017,1518.0,1719.0,1921.0,28.9,76458.0,807,36071014601
36,071,014601,4,Block Group 4; Census Tract 146.01; Orange County; New York,22,251,273,0,0,0,0,0,22,0,251,273,82,7,31,123,8,22,2010,2011,-666666666,,,,,140170.0,740,36071014601
36,071,014602,1,Block Group 1; Census Tract 146.02; Orange County; New York,134,262,396,76,13,0,0,45,0,10,262,396,14,38,87,72,41,134,2009,2012,2019,974.0,1072.0,1183.0,51.0,64688.0,1069,36071014602
36,071,014602,2,Block Group 2; Census Tract 146.02; Orange County; New York,166,236,402,15,0,0,0,0,151,0,236,402,74,21,85,17,39,166,2003,2011,2014,1137.0,1276.0,1431.0,51.0,142586.0,1197,36071014602
36,071,014602,3,Block Group 3; Census Tract 146.02; Orange County; New York,121,392,513,83,0,0,0,0,38,0,392,513,63,18,105,197,9,121,2010,2012,2019,1085.0,1170.0,1527.0,37.1,161367.0,1225,36071014602
36,071,014700,1,Block Group 1; Census Tract 147; Orange County; New York,50,522,572,50,0,0,0,0,0,8,522,572,116,281,34,67,16,50,1995,1996,-666666666,,,,,114375.0,1555,36071014700
36,071,014700,2,Block Group 2; Census Tract 147; Orange County; New York,32,851,883,0,0,0,0,0,32,0,851,883,119,106,229,276,121,32,2009,2009,-666666666,1127.0,2008.0,2254.0,,142838.0,2472,36071014700
36,071,014801,1,Block Group 1; Census Tract 148.01; Orange County; New York,4,197,201,0,0,0,0,0,4,23,197,201,27,42,20,55,30,4,2011,2012,-666666666,,,,,207708.0,756,36071014801
36,071,014801,2,Block Group 2; Census Tract 148.01; Orange County; New York,107,356,463,25,54,0,0,0,28,0,356,463,91,7,139,96,23,107,2006,2010,2022,1368.0,1601.0,1800.0,51.0,78665.0,1460,36071014801
36,071,014801,3,Block Group 3; Census Tract 148.01; Orange County; New York,76,322,398,23,0,0,0,0,53,22,322,398,44,88,117,10,41,76,2002,2006,2016,1568.0,1824.0,3120.0,29.8,110395.0,1063,36071014801
36,071,014802,1,Block Group 1; Census Tract 148.02; Orange County; New York,0,233,233,0,0,0,0,0,0,0,233,233,90,10,73,36,24,0,2002,2002,-666666666,,,,,122458.0,953,36071014802
36,071,014802,2,Block Group 2; Census Tract 148.02; Orange County; New York,0,335,335,0,0,0,0,0,0,0,335,335,193,44,15,83,0,0,1989,1989,-666666666,,,,51.0,68487.0,928,36071014802
36,071,014802,3,Block Group 3; Census Tract 148.02; Orange County; New York,183,273,456,68,0,0,48,0,67,22,273,456,41,31,117,62,0,183,2006,2009,2015,1043.0,1122.0,1409.0,24.0,72115.0,1047,36071014802
36,071,014900,1,Block Group 1; Census Tract 149; Orange County; New York,109,317,426,79,0,5,0,12,13,46,317,426,78,8,93,63,29,109,2008,2012,2019,1664.0,1828.0,1992.0,28.8,101462.0,1197,36071014900
36,071,014900,2,Block Group 2; Census Tract 149; Orange County; New York,47,390,437,18,2,0,10,2,15,21,390,437,51,42,48,198,30,47,2012,2012,2016,1158.0,1361.0,2583.0,27.0,250001.0,768,36071014900
36,071,014900,3,Block Group 3; Census Tract 149; Orange County; New York,187,478,665,88,19,0,0,15,65,5,478,665,33,118,162,144,16,187,2005,2010,2018,948.0,996.0,1375.0,43.2,161875.0,1807,36071014900
36,071,015003,1,Block Group 1; Census Tract 150.03; Orange County; New York,204,122,326,17,0,52,0,10,125,0,122,326,13,19,27,63,0,204,2010,2012,2013,,1094.0,1286.0,51.0,,1879,36071015003
36,071,015003,2,Block Group 2; Census Tract 150.03; Orange County; New York,625,360,985,151,41,0,0,40,393,0,360,985,0,0,49,254,57,625,2014,2015,2016,1363.0,1712.0,1955.0,51.0,51425.0,6570,36071015003
36,071,015003,3,Block Group 3; Census Tract 150.03; Orange County; New York,326,168,494,110,0,39,5,34,138,0,168,494,0,11,30,9,118,326,2019,2017,2015,706.0,1041.0,1702.0,38.9,43779.0,2309,36071015003
36,071,015005,1,Block Group 1; Census Tract 150.05; Orange County; New York,473,257,730,37,20,0,0,50,366,25,257,730,11,0,79,130,12,473,2012,2014,2014,1294.0,1457.0,1742.0,51.0,55655.0,4193,36071015005
36,071,015005,2,Block Group 2; Census Tract 150.05; Orange County; New York,428,45,473,77,0,0,16,97,238,0,45,473,0,22,0,11,12,428,2010,2013,2013,703.0,761.0,1345.0,46.3,29535.0,2331,36071015005
36,071,015007,1,Block Group 1; Census Tract 150.07; Orange County; New York,371,204,575,48,0,0,114,56,153,0,204,575,6,0,116,43,39,371,2008,2010,2011,1050.0,891.0,1375.0,51.0,35117.0,3322,36071015007
36,071,015007,2,Block Group 2; Census Tract 150.07; Orange County; New York,156,147,303,98,0,0,0,0,58,0,147,303,0,0,24,37,86,156,2018,2019,2019,848.0,896.0,1662.0,51.0,,1678,36071015007
36,071,015007,3,Block Group 3; Census Tract 150.07; Orange County; New York,91,58,149,0,0,0,0,31,60,0,58,149,0,21,17,20,0,91,2005,2011,2012,942.0,1083.0,1707.0,41.8,36525.0,1002,36071015007
36,071,015008,1,Block Group 1; Census Tract 150.08; Orange County; New York,542,49,591,147,12,5,0,86,292,0,49,591,14,0,5,15,15,542,2013,2015,2015,906.0,1054.0,1385.0,51.0,27009.0,2913,36071015008
36,071,015008,2,Block Group 2; Census Tract 150.08; Orange County; New York,279,64,343,12,10,19,36,29,173,0,64,343,20,21,0,23,0,279,1996,2012,2013,1020.0,1208.0,1450.0,51.0,30055.0,1368,36071015008
36,071,015009,1,Block Group 1; Census Tract 150.09; Orange County; New York,275,136,411,99,0,0,0,109,67,0,136,411,3,15,41,77,0,275,2011,2012,2013,906.0,975.0,1251.0,51.0,33042.0,1653,36071015009
36,071,015009,2,Block Group 2; Census Tract 150.09; Orange County; New York,35,89,124,0,0,0,0,30,5,0,89,124,0,0,73,16,0,35,2006,2006,2006,1617.0,1891.0,2188.0,45.8,86181.0,1082,36071015009
36,071,015010,1,Block Group 1; Census Tract 150.10; Orange County; New York,43,111,154,10,0,0,0,5,28,0,111,154,44,12,17,38,0,43,2000,2010,2015,1112.0,1224.0,1717.0,51.0,29063.0,893,36071015010
36,071,015010,2,Block Group 2; Census Tract 150.10; Orange County; New York,267,113,380,52,7,0,0,45,163,0,113,380,0,0,31,73,9,267,2013,2014,2014,746.0,1168.0,1673.0,51.0,47353.0,2020,36071015010
36,071,015010,3,Block Group 3; Census Tract 150.10; Orange County; New York,218,147,365,16,17,0,0,31,154,0,147,365,0,25,59,52,11,218,2008,2013,2014,1007.0,1174.0,1370.0,37.2,40655.0,2162,36071015010
36,071,015100,1,Block Group 1; Census Tract 151; Orange County; New York,242,103,345,123,18,23,0,32,46,0,103,345,0,0,103,0,0,242,-666666666,2013,2018,694.0,840.0,1402.0,38.2,25810.0,844,36071015100
36,071,015100,2,Block Group 2; Census Tract 151; Orange County; New York,235,154,389,62,0,0,45,39,89,0,154,389,50,0,0,18,86,235,2018,2015,2013,1277.0,1392.0,1526.0,21.9,131014.0,1317,36071015100
36,071,015100,3,Block Group 3; Census Tract 151; Orange County; New York,51,142,193,0,0,0,0,51,0,0,142,193,19,12,69,42,0,51,2006,2005,-666666666,844.0,,1450.0,30.6,62519.0,507,36071015100
36,071,015100,4,Block Group 4; Census Tract 151; Orange County; New York,124,112,236,22,0,0,0,0,102,0,112,236,0,95,0,17,0,124,1996,2012,2015,1028.0,1123.0,1219.0,45.8,125902.0,928,36071015100
36,071,015100,5,Block Group 5; Census Tract 151; Orange County; New York,364,204,568,40,0,0,0,17,307,0,204,568,0,36,149,0,19,364,2004,2012,2014,649.0,787.0,1069.0,39.2,23958.0,2252,36071015100
36,071,015100,6,Block Group 6; Census Tract 151; Orange County; New York,185,132,317,16,0,0,0,0,169,0,132,317,41,45,20,26,0,185,1996,2012,2014,1001.0,1095.0,1189.0,49.4,,751,36071015100
36,071,015201,1,Block Group 1; Census Tract 152.01; Orange County; New York,108,561,669,50,0,0,0,58,0,13,561,669,101,118,106,191,32,108,2006,2007,2009,1415.0,1882.0,2730.0,31.3,112525.0,1768,36071015201
36,071,015201,2,Block Group 2; Census Tract 152.01; Orange County; New York,73,635,708,0,0,13,0,0,60,0,635,708,95,84,179,184,93,73,2008,2009,-666666666,,,,,145385.0,2526,36071015201
36,071,015202,1,Block Group 1; Census Tract 152.02; Orange County; New York,9,735,744,9,0,0,0,0,0,25,735,744,30,0,329,194,157,9,2010,2011,-666666666,,,,,168900.0,2648,36071015202
36,071,015202,2,Block Group 2; Census Tract 152.02; Orange County; New York,79,408,487,24,0,0,0,0,55,0,408,487,68,18,262,55,5,79,2005,2006,2016,1258.0,1464.0,1726.0,51.0,200852.0,1414,36071015202
36,071,015202,3,Block Group 3; Census Tract 152.02; Orange County; New York,190,272,462,0,0,0,144,0,46,0,272,462,52,27,119,42,32,190,2005,2001,1997,911.0,941.0,970.0,51.0,52240.0,1239,36071015202
36,071,015203,1,Block Group 1; Census Tract 152.03; Orange County; New York,375,0,375,154,55,0,0,24,142,0,0,375,0,0,0,0,0,375,-666666666,2018,2018,1649.0,1977.0,2251.0,29.5,74915.0,904,36071015203
36,071,015203,2,Block Group 2; Census Tract 152.03; Orange County; New York,0,194,194,0,0,0,0,0,0,0,194,194,12,0,0,172,10,0,2014,2014,-666666666,,,,,158125.0,664,36071015203
36,079,010201,1,Block Group 1; Census Tract 102.01; Putnam County; New York,0,233,233,0,0,0,0,0,0,0,233,233,42,25,117,38,11,0,2004,2004,-666666666,,,,,145313.0,632,36079010201
36,079,010201,2,Block Group 2; Census Tract 102.01; Putnam County; New York,183,712,895,116,11,0,0,24,32,46,712,895,171,43,192,164,96,183,2007,2011,2019,1379.0,1514.0,1757.0,51.0,93931.0,2132,36079010201
36,079,010201,3,Block Group 3; Census Tract 102.01; Putnam County; New York,0,512,512,0,0,0,0,0,0,0,512,512,38,51,104,74,245,0,2017,2017,-666666666,,,,,205333.0,1502,36079010201
36,079,010300,1,Block Group 1; Census Tract 103; Putnam County; New York,17,582,599,0,0,17,0,0,0,12,582,599,129,78,150,111,102,17,2006,2005,-666666666,,,,,98380.0,1740,36079010300
36,079,010300,2,Block Group 2; Census Tract 103; Putnam County; New York,43,148,191,31,0,12,0,0,0,0,148,191,22,11,47,68,0,43,2009,2010,-666666666,1992.0,2165.0,2332.0,19.3,162944.0,567,36079010300
36,079,010300,3,Block Group 3; Census Tract 103; Putnam County; New York,0,301,301,0,0,0,0,0,0,0,301,301,60,12,110,62,57,0,2007,2007,-666666666,,,,,177917.0,908,36079010300
36,079,010300,4,Block Group 4; Census Tract 103; Putnam County; New York,48,545,593,0,0,9,0,28,11,0,545,593,115,104,126,134,66,48,2004,2004,2005,1385.0,1536.0,1768.0,51.0,102313.0,1555,36079010300
36,079,010400,1,Block Group 1; Census Tract 104; Putnam County; New York,53,331,384,0,15,0,27,0,11,0,331,384,117,25,73,62,54,53,2003,2003,2000,2042.0,2287.0,2558.0,30.4,93900.0,1166,36079010400
36,079,010400,2,Block Group 2; Census Tract 104; Putnam County; New York,21,155,176,0,0,10,11,0,0,0,155,176,69,45,18,23,0,21,1992,1992,-666666666,,,,,136071.0,553,36079010400
36,079,010400,3,Block Group 3; Census Tract 104; Putnam County; New York,121,499,620,53,0,0,0,4,64,0,499,620,62,83,153,179,22,121,2007,2010,2017,1135.0,1307.0,1410.0,39.3,72000.0,1514,36079010400
36,079,010500,1,Block Group 1; Census Tract 105; Putnam County; New York,91,359,450,27,0,0,0,33,31,0,359,450,111,49,60,105,34,91,2003,2007,2013,873.0,1360.0,2079.0,27.7,131351.0,1366,36079010500
36,079,010500,2,Block Group 2; Census Tract 105; Putnam County; New York,48,536,584,26,0,0,0,9,13,0,536,584,117,71,163,102,83,48,2005,2006,2018,1086.0,1171.0,1269.0,51.0,144500.0,1435,36079010500
36,079,010500,3,Block Group 3; Census Tract 105; Putnam County; New York,85,775,860,7,0,0,0,0,78,21,775,860,240,153,129,159,73,85,2000,2003,2014,1138.0,1575.0,1963.0,28.0,169063.0,2136,36079010500
36,079,010600,1,Block Group 1; Census Tract 106; Putnam County; New York,28,191,219,14,0,0,0,0,14,0,191,219,33,61,55,35,7,28,2000,2003,2018,1889.0,2192.0,2462.0,51.0,169821.0,592,36079010600
36,079,010600,2,Block Group 2; Census Tract 106; Putnam County; New York,102,490,592,10,0,0,0,9,83,4,490,592,93,98,192,91,12,102,2003,2005,2014,1036.0,2000.0,2311.0,14.1,188889.0,1375,36079010600
36,079,010600,3,Block Group 3; Census Tract 106; Putnam County; New York,68,586,654,0,8,12,0,0,48,7,586,654,44,111,198,127,99,68,2007,2008,2014,1048.0,1098.0,3501.0,18.9,121833.0,1772,36079010600
36,079,011000,1,Block Group 1; Census Tract 110; Putnam County; New York,36,258,294,0,11,0,25,0,0,0,258,294,79,67,68,33,11,36,1997,1997,-666666666,,,,,111346.0,715,36079011000
36,079,011000,2,Block Group 2; Census Tract 110; Putnam County; New York,79,282,361,10,0,3,41,25,0,5,282,361,59,70,107,19,22,79,2001,2001,1999,,,,,176756.0,1088,36079011000
36,079,011000,3,Block Group 3; Census Tract 110; Putnam County; New York,19,353,372,0,0,0,0,0,19,0,353,372,86,80,49,108,30,19,2002,2004,-666666666,,,,,181818.0,1093,36079011000
36,079,011000,4,Block Group 4; Census Tract 110; Putnam County; New York,15,411,426,0,0,0,0,8,7,0,411,426,71,71,158,97,14,15,2004,2004,-666666666,,,3501.0,26.6,116143.0,1231,36079011000
36,083,052501,1,Block Group 1; Census Tract 525.01; Rensselaer County; New York,0,475,475,0,0,0,0,0,0,63,475,475,141,107,38,76,50,0,1999,1999,-666666666,786.0,856.0,1265.0,23.4,122396.0,962,36083052501
36,083,052501,2,Block Group 2; Census Tract 525.01; Rensselaer County; New York,18,422,440,0,0,0,0,0,18,0,422,440,101,38,135,76,72,18,2005,2006,-666666666,,,,,138553.0,1009,36083052501
36,083,052501,3,Block Group 3; Census Tract 525.01; Rensselaer County; New York,42,874,916,15,0,0,0,0,27,57,874,916,275,142,102,233,65,42,2002,2004,-666666666,809.0,876.0,1097.0,37.1,93226.0,2160,36083052501
36,083,052501,4,Block Group 4; Census Tract 525.01; Rensselaer County; New York,49,477,526,24,0,0,16,0,9,0,477,526,88,75,109,159,46,49,2007,2008,2018,,825.0,977.0,26.7,131724.0,1539,36083052501
36,083,052502,1,Block Group 1; Census Tract 525.02; Rensselaer County; New York,141,1069,1210,48,0,0,0,0,93,0,1069,1210,297,148,224,217,183,141,2004,2007,2016,1014.0,1109.0,1204.0,17.4,94943.0,3197,36083052502
36,083,052502,2,Block Group 2; Census Tract 525.02; Rensselaer County; New York,34,426,460,0,0,0,0,0,34,0,426,460,77,42,132,144,31,34,2007,2008,-666666666,,,,,136280.0,1093,36083052502
36,083,052502,3,Block Group 3; Census Tract 525.02; Rensselaer County; New York,53,250,303,0,0,32,0,21,0,0,250,303,39,33,66,38,74,53,2008,2005,1989,,,,,119094.0,658,36083052502
36,083,052502,4,Block Group 4; Census Tract 525.02; Rensselaer County; New York,292,179,471,122,0,0,0,0,170,0,179,471,57,41,36,24,21,292,1998,2014,2017,1545.0,1736.0,1927.0,47.6,56850.0,782,36083052502
36,083,052503,1,Block Group 1; Census Tract 525.03; Rensselaer County; New York,238,388,626,100,7,6,3,3,119,16,388,626,72,35,85,134,46,238,2010,2013,2017,832.0,965.0,1138.0,34.0,59453.0,1480,36083052503
36,083,052601,1,Block Group 1; Census Tract 526.01; Rensselaer County; New York,113,595,708,69,7,0,0,0,37,0,595,708,214,81,80,170,50,113,2000,2007,2019,664.0,1283.0,2147.0,22.6,88426.0,1783,36083052601
36,083,052601,2,Block Group 2; Census Tract 526.01; Rensselaer County; New York,124,586,710,13,0,4,14,55,38,0,586,710,130,109,126,163,58,124,2004,2005,2008,587.0,783.0,846.0,18.5,87500.0,1679,36083052601
36,083,052602,1,Block Group 1; Census Tract 526.02; Rensselaer County; New York,179,290,469,52,13,0,0,0,114,7,290,469,80,40,116,40,7,179,2002,2010,2016,605.0,774.0,871.0,28.6,74931.0,1169,36083052602
36,083,052603,1,Block Group 1; Census Tract 526.03; Rensselaer County; New York,125,474,599,26,0,0,7,49,43,11,474,599,104,82,135,127,15,125,2004,2006,2011,541.0,916.0,987.0,25.3,80817.0,1434,36083052603
36,083,052603,2,Block Group 2; Census Tract 526.03; Rensselaer County; New York,100,459,559,7,0,0,0,35,58,2,459,559,53,175,47,146,36,100,2000,2006,2012,848.0,925.0,1058.0,21.0,92946.0,1367,36083052603
36,105,950100,1,Block Group 1; Census Tract 9501; Sullivan County; New York,43,219,262,8,11,0,0,7,17,12,219,262,24,8,117,53,5,43,2007,2008,2017,,,,,,694,36105950100
36,105,950100,2,Block Group 2; Census Tract 9501; Sullivan County; New York,35,389,424,27,0,0,0,0,8,9,389,424,183,33,90,53,21,35,1993,1999,2019,566.0,582.0,599.0,31.8,148393.0,823,36105950100
36,105,950100,3,Block Group 3; Census Tract 9501; Sullivan County; New York,140,216,356,51,0,0,12,24,53,22,216,356,93,22,24,46,9,140,1997,2010,2015,844.0,1066.0,1301.0,35.7,65500.0,1052,36105950100
36,105,950100,4,Block Group 4; Census Tract 9501; Sullivan County; New York,24,389,413,0,0,0,24,0,0,0,389,413,104,144,20,58,63,24,1996,1996,-666666666,,,,,70150.0,819,36105950100
36,105,950201,1,Block Group 1; Census Tract 9502.01; Sullivan County; New York,11,226,237,11,0,0,0,0,0,15,226,237,59,38,73,41,0,11,2002,2003,-666666666,,,,,41932.0,479,36105950201
36,105,950201,2,Block Group 2; Census Tract 9502.01; Sullivan County; New York,16,481,497,0,0,0,0,0,16,0,481,497,221,88,59,76,37,16,1992,1993,-666666666,722.0,743.0,1129.0,19.3,57880.0,947,36105950201
36,105,950201,3,Block Group 3; Census Tract 9502.01; Sullivan County; New York,96,94,190,10,0,0,52,0,34,0,94,190,18,11,33,32,0,96,2005,2004,1999,567.0,815.0,871.0,36.0,70357.0,489,36105950201
36,105,950202,1,Block Group 1; Census Tract 9502.02; Sullivan County; New York,60,284,344,8,0,0,0,0,52,0,284,344,61,57,39,57,70,60,2006,2011,2015,1034.0,1106.0,1178.0,20.2,66420.0,840,36105950202
36,105,950202,2,Block Group 2; Census Tract 9502.02; Sullivan County; New York,40,255,295,0,0,0,0,16,24,0,255,295,124,10,35,69,17,40,1994,2003,2011,495.0,528.0,662.0,51.0,37625.0,562,36105950202
36,105,950300,1,Block Group 1; Census Tract 9503; Sullivan County; New York,80,188,268,11,23,0,0,8,38,0,188,268,67,39,39,41,2,80,1997,2006,2017,575.0,735.0,1102.0,33.3,50000.0,671,36105950300
36,105,950300,2,Block Group 2; Census Tract 9503; Sullivan County; New York,42,201,243,4,10,0,10,7,11,2,201,243,4,66,73,39,17,42,2004,2005,2013,503.0,,1331.0,18.4,81375.0,563,36105950300
36,105,950400,1,Block Group 1; Census Tract 9504; Sullivan County; New York,56,550,606,35,0,0,21,0,0,0,550,606,83,112,151,191,13,56,2005,2006,2019,849.0,897.0,949.0,51.0,81119.0,1347,36105950400
36,105,950400,2,Block Group 2; Census Tract 9504; Sullivan County; New York,52,367,419,6,0,0,0,0,46,0,367,419,143,54,34,97,39,52,1998,2004,2015,573.0,596.0,631.0,19.6,71906.0,791,36105950400
36,105,950400,3,Block Group 3; Census Tract 9504; Sullivan County; New York,101,262,363,45,27,1,0,4,24,20,262,363,66,30,79,53,14,101,2004,2010,2019,797.0,863.0,961.0,47.5,93125.0,868,36105950400
36,105,950500,1,Block Group 1; Census Tract 9505; Sullivan County; New York,181,117,298,109,15,0,0,6,51,13,117,298,15,34,40,15,0,181,2002,2017,2019,478.0,818.0,867.0,32.3,35978.0,637,36105950500
36,105,950500,2,Block Group 2; Census Tract 9505; Sullivan County; New York,219,318,537,32,32,0,57,23,75,29,318,537,155,0,37,97,0,219,2001,2009,2013,483.0,586.0,870.0,24.8,56818.0,1371,36105950500
36,105,950500,3,Block Group 3; Census Tract 9505; Sullivan County; New York,82,144,226,0,0,0,0,49,33,0,144,226,49,22,10,38,25,82,2001,2007,2008,817.0,828.0,1744.0,24.4,85688.0,551,36105950500
36,105,950500,4,Block Group 4; Census Tract 9505; Sullivan County; New York,7,221,228,0,0,0,0,0,7,26,221,228,26,25,127,17,0,7,2005,2005,-666666666,,,,,73750.0,926,36105950500
36,105,950600,1,Block Group 1; Census Tract 9506; Sullivan County; New York,38,352,390,0,5,0,0,0,33,69,352,390,90,41,84,39,29,38,2005,2008,2015,319.0,1056.0,1153.0,26.7,82174.0,889,36105950600
36,105,950600,2,Block Group 2; Census Tract 9506; Sullivan County; New York,3,220,223,0,0,0,3,0,0,0,220,223,76,27,20,79,18,3,2004,2003,-666666666,,,,,45179.0,341,36105950600
36,105,950600,3,Block Group 3; Census Tract 9506; Sullivan County; New York,89,105,194,13,12,0,12,22,30,0,105,194,7,19,58,21,0,89,2005,2007,2013,851.0,996.0,1124.0,41.5,58077.0,474,36105950600
36,105,950701,1,Block Group 1; Census Tract 9507.01; Sullivan County; New York,116,71,187,30,0,0,16,0,70,0,71,187,26,0,8,0,37,116,2018,2015,2015,772.0,863.0,1108.0,26.1,63774.0,729,36105950701
36,105,950701,2,Block Group 2; Census Tract 9507.01; Sullivan County; New York,364,49,413,159,24,0,0,0,181,19,49,413,16,0,14,0,0,364,2006,2018,2018,762.0,835.0,956.0,32.7,36128.0,1441,36105950701
36,105,950701,3,Block Group 3; Census Tract 9507.01; Sullivan County; New York,189,130,319,87,0,14,0,55,33,0,130,319,0,7,63,60,0,189,2009,2012,2016,905.0,1003.0,1513.0,28.9,71875.0,950,36105950701
36,105,950701,4,Block Group 4; Census Tract 9507.01; Sullivan County; New York,67,11,78,0,0,0,0,13,54,0,11,78,11,0,0,0,0,67,-666666666,2012,2013,753.0,812.0,856.0,29.4,43158.0,241,36105950701
36,105,950702,1,Block Group 1; Census Tract 9507.02; Sullivan County; New York,215,166,381,0,0,25,0,16,174,0,166,381,37,0,129,0,0,215,2004,2009,2013,,704.0,804.0,22.9,43638.0,980,36105950702
36,105,950702,2,Block Group 2; Census Tract 9507.02; Sullivan County; New York,84,119,203,0,10,0,25,0,49,0,119,203,16,47,35,0,21,84,1999,2004,2013,1112.0,1250.0,1375.0,14.8,121394.0,673,36105950702
36,105,950801,1,Block Group 1; Census Tract 9508.01; Sullivan County; New York,54,26,80,23,0,0,0,0,31,0,26,80,0,13,13,0,0,54,-666666666,2014,-666666666,848.0,895.0,953.0,24.8,56635.0,582,36105950801
36,105,950801,2,Block Group 2; Census Tract 9508.01; Sullivan County; New York,120,46,166,30,0,0,0,0,90,0,46,166,0,0,46,0,0,120,-666666666,2013,2015,716.0,737.0,1100.0,44.8,51815.0,857,36105950801
36,105,950801,3,Block Group 3; Census Tract 9508.01; Sullivan County; New York,53,360,413,44,0,0,0,0,9,27,360,413,14,72,78,169,0,53,2011,2012,-666666666,,,,,58949.0,858,36105950801
36,105,950802,1,Block Group 1; Census Tract 9508.02; Sullivan County; New York,138,353,491,63,0,43,0,0,32,10,353,491,42,100,100,87,14,138,2003,2006,2017,490.0,824.0,895.0,9.0,103750.0,1186,36105950802
36,105,950802,2,Block Group 2; Census Tract 9508.02; Sullivan County; New York,85,205,290,0,32,0,0,39,14,0,205,290,0,28,88,68,21,85,2008,2009,2012,840.0,880.0,934.0,51.0,28096.0,757,36105950802
36,105,950900,1,Block Group 1; Census Tract 9509; Sullivan County; New York,131,333,464,0,10,0,0,0,121,0,333,464,177,31,7,44,74,131,1989,2011,2014,,582.0,,20.4,72386.0,1194,36105950900
36,105,950900,2,Block Group 2; Census Tract 9509; Sullivan County; New York,204,223,427,113,0,0,0,12,79,0,223,427,81,40,39,25,38,204,1998,2013,2018,582.0,839.0,984.0,31.4,36563.0,1208,36105950900
36,105,950900,3,Block Group 3; Census Tract 9509; Sullivan County; New York,206,39,245,90,0,7,0,49,60,0,39,245,0,39,0,0,0,206,-666666666,2014,2016,589.0,986.0,1305.0,24.7,60577.0,1238,36105950900
36,105,951000,1,Block Group 1; Census Tract 9510; Sullivan County; New York,223,169,392,53,0,0,0,90,80,0,169,392,46,22,0,101,0,223,2011,2012,2012,748.0,780.0,1001.0,36.7,68362.0,805,36105951000
36,105,951000,2,Block Group 2; Census Tract 9510; Sullivan County; New York,51,239,290,28,0,0,0,10,13,49,239,290,7,25,115,20,23,51,2008,2009,2018,,244.0,1082.0,34.8,87400.0,946,36105951000
36,105,951000,3,Block Group 3; Census Tract 9510; Sullivan County; New York,286,121,407,75,37,0,0,35,139,0,121,407,76,13,26,6,0,286,1989,2013,2016,277.0,762.0,938.0,17.7,66371.0,784,36105951000
36,105,951100,1,Block Group 1; Census Tract 9511; Sullivan County; New York,140,246,386,26,0,0,28,0,86,0,246,386,27,75,41,94,9,140,2005,2011,2014,592.0,746.0,1115.0,21.9,58438.0,912,36105951100
36,105,951100,2,Block Group 2; Census Tract 9511; Sullivan County; New York,47,55,102,10,0,7,0,0,30,0,55,102,13,12,28,2,0,47,2001,2007,2014,,1617.0,1768.0,36.0,76000.0,2412,36105951100
36,105,951100,3,Block Group 3; Census Tract 9511; Sullivan County; New York,71,159,230,56,0,0,0,15,0,0,159,230,18,34,34,22,51,71,2008,2015,2019,1018.0,1131.0,1245.0,19.4,91813.0,465,36105951100
36,105,951201,1,Block Group 1; Census Tract 9512.01; Sullivan County; New York,90,415,505,0,0,0,0,90,0,10,415,505,52,0,79,156,118,90,2014,2012,-666666666,959.0,1034.0,948.0,32.7,90640.0,1575,36105951201
36,105,951201,2,Block Group 2; Census Tract 9512.01; Sullivan County; New York,22,362,384,22,0,0,0,0,0,4,362,384,10,95,63,157,33,22,2011,2011,-666666666,,,,,78500.0,947,36105951201
36,105,951201,3,Block Group 3; Census Tract 9512.01; Sullivan County; New York,91,310,401,45,23,0,0,10,13,6,310,401,75,41,88,77,23,91,2004,2009,2020,896.0,1128.0,1289.0,29.4,74464.0,924,36105951201
36,105,951201,4,Block Group 4; Census Tract 9512.01; Sullivan County; New York,27,311,338,0,0,0,0,0,27,0,311,338,47,65,65,111,23,27,2007,2009,-666666666,,,,,123235.0,1273,36105951201
36,105,951202,1,Block Group 1; Census Tract 9512.02; Sullivan County; New York,0,386,386,0,0,0,0,0,0,0,386,386,88,46,142,84,26,0,2004,2004,-666666666,,,,,175000.0,1079,36105951202
36,105,951202,2,Block Group 2; Census Tract 9512.02; Sullivan County; New York,361,82,443,135,46,0,1,4,175,0,82,443,9,8,10,55,0,361,2012,2017,2018,528.0,994.0,1142.0,39.8,40583.0,1592,36105951202
36,105,951202,3,Block Group 3; Census Tract 9512.02; Sullivan County; New York,109,247,356,59,0,0,0,9,41,25,247,356,71,25,9,77,40,109,2012,2014,2018,1327.0,1443.0,1668.0,19.6,71638.0,1265,36105951202
36,105,951301,1,Block Group 1; Census Tract 9513.01; Sullivan County; New York,38,293,331,0,0,0,28,10,0,8,293,331,52,0,136,51,46,38,2007,2006,-666666666,,,,,97583.0,723,36105951301
36,105,951301,2,Block Group 2; Census Tract 9513.01; Sullivan County; New York,84,313,397,0,0,0,0,0,84,0,313,397,36,45,97,86,49,84,2008,2011,-666666666,1078.0,1156.0,1234.0,18.1,106250.0,1189,36105951301
36,105,951302,1,Block Group 1; Census Tract 9513.02; Sullivan County; New York,78,421,499,57,0,0,0,0,21,0,421,499,87,50,155,120,9,78,2005,2007,2019,731.0,744.0,1685.0,18.7,96094.0,1158,36105951302
36,105,951302,2,Block Group 2; Census Tract 9513.02; Sullivan County; New York,56,103,159,17,19,0,0,6,14,0,103,159,54,11,0,11,27,56,1989,2013,2019,633.0,713.0,938.0,48.6,86029.0,262,36105951302
36,105,951302,3,Block Group 3; Census Tract 9513.02; Sullivan County; New York,24,215,239,16,8,0,0,0,0,17,215,239,10,0,101,33,54,24,2010,2012,2020,1125.0,1375.0,1875.0,37.5,52792.0,624,36105951302
36,105,951500,1,Block Group 1; Census Tract 9515; Sullivan County; New York,276,267,543,138,0,0,0,32,106,0,267,543,112,121,23,11,0,276,1992,2007,2018,650.0,774.0,1031.0,27.3,52361.0,950,36105951500
36,105,951500,2,Block Group 2; Census Tract 9515; Sullivan County; New York,78,312,390,34,0,0,3,10,31,0,312,390,72,12,65,127,36,78,2010,2012,2017,843.0,,3501.0,32.5,73600.0,1251,36105951500
36,105,951500,3,Block Group 3; Census Tract 9515; Sullivan County; New York,142,102,244,48,0,0,34,28,32,0,102,244,48,0,11,0,43,142,2003,2010,2012,,944.0,990.0,37.5,18088.0,836,36105951500
36,105,951600,1,Block Group 1; Census Tract 9516; Sullivan County; New York,137,205,342,29,0,0,0,0,108,0,205,342,75,4,25,101,0,137,2009,2013,2015,624.0,1044.0,1176.0,24.8,88310.0,752,36105951600
36,105,951600,2,Block Group 2; Census Tract 9516; Sullivan County; New York,78,284,362,14,36,0,0,11,17,0,284,362,70,13,81,87,33,78,2007,2010,2020,573.0,1053.0,1176.0,9.0,79167.0,1077,36105951600
36,105,951600,3,Block Group 3; Census Tract 9516; Sullivan County; New York,236,94,330,158,0,0,0,0,78,0,94,330,47,0,0,47,0,236,2000,2018,2019,667.0,732.0,809.0,38.2,,1273,36105951600
36,105,951600,4,Block Group 4; Census Tract 9516; Sullivan County; New York,276,123,399,59,17,0,0,37,163,0,123,399,0,11,11,57,44,276,2016,2015,2015,967.0,1154.0,1382.0,32.8,47109.0,1015,36105951600
36,105,951701,1,Block Group 1; Census Tract 9517.01; Sullivan County; New York,35,306,341,0,0,11,0,4,20,8,306,341,60,52,120,55,11,35,2003,2004,2011,324.0,672.0,695.0,23.3,90804.0,684,36105951701
36,105,951701,2,Block Group 2; Census Tract 9517.01; Sullivan County; New York,118,489,607,21,0,0,0,25,72,11,489,607,56,10,108,282,22,118,2012,2012,2014,1301.0,1410.0,2132.0,27.3,106089.0,1488,36105951701
36,105,951701,3,Block Group 3; Census Tract 9517.01; Sullivan County; New York,50,322,372,25,0,25,0,0,0,0,322,372,112,63,53,94,0,50,1998,1998,2004,849.0,899.0,1123.0,21.3,111786.0,1144,36105951701
36,105,951702,1,Block Group 1; Census Tract 9517.02; Sullivan County; New York,14,363,377,0,3,0,0,3,8,12,363,377,98,43,85,62,63,14,2005,2005,2014,969.0,1125.0,1656.0,32.5,148125.0,884,36105951702
36,105,951801,1,Block Group 1; Census Tract 9518.01; Sullivan County; New York,134,160,294,82,0,0,52,0,0,0,160,294,0,83,77,0,0,134,2000,2002,2019,,761.0,1035.0,27.9,78269.0,615,36105951801
36,105,951801,2,Block Group 2; Census Tract 9518.01; Sullivan County; New York,533,77,610,178,16,0,0,232,107,0,77,610,0,0,0,77,0,533,-666666666,2013,2013,612.0,711.0,901.0,30.6,30536.0,1301,36105951801
36,105,951801,3,Block Group 3; Census Tract 9518.01; Sullivan County; New York,116,44,160,56,0,29,0,0,31,0,44,160,0,22,0,22,0,116,-666666666,2014,2017,1110.0,1220.0,3501.0,51.0,46750.0,537,36105951801
36,105,951801,4,Block Group 4; Census Tract 9518.01; Sullivan County; New York,79,58,137,59,0,0,0,0,20,0,58,137,37,0,0,21,0,79,1989,2016,2019,,1665.0,1833.0,23.3,93685.0,454,36105951801
36,105,951802,1,Block Group 1; Census Tract 9518.02; Sullivan County; New York,128,14,142,40,0,0,0,16,72,0,14,142,0,0,0,0,14,128,-666666666,2016,2015,721.0,893.0,1123.0,35.9,40530.0,532,36105951802
36,105,951802,2,Block Group 2; Census Tract 9518.02; Sullivan County; New York,35,122,157,0,0,0,0,0,35,0,122,157,25,14,83,0,0,35,2003,2005,-666666666,934.0,1095.0,2050.0,22.8,117386.0,795,36105951802
36,105,951802,3,Block Group 3; Census Tract 9518.02; Sullivan County; New York,230,0,230,117,0,0,0,45,68,0,0,230,0,0,0,0,0,230,-666666666,2018,2018,787.0,1005.0,1146.0,44.0,29360.0,553,36105951802
36,105,951802,4,Block Group 4; Census Tract 9518.02; Sullivan County; New York,223,51,274,158,7,4,0,0,54,0,51,274,14,37,0,0,0,223,-666666666,2019,2019,863.0,976.0,1685.0,51.0,14073.0,335,36105951802
36,105,951802,5,Block Group 5; Census Tract 9518.02; Sullivan County; New York,173,99,272,0,0,0,0,16,157,0,99,272,47,3,18,31,0,173,1998,2012,2014,574.0,597.0,1192.0,32.9,56602.0,915,36105951802
36,105,951900,1,Block Group 1; Census Tract 9519; Sullivan County; New York,34,266,300,12,0,0,0,0,22,0,266,300,61,59,35,85,26,34,2004,2009,-666666666,,,,,80577.0,713,36105951900
36,105,951900,2,Block Group 2; Census Tract 9519; Sullivan County; New York,143,250,393,48,0,0,0,12,83,0,250,393,16,50,77,83,24,143,2008,2012,2016,842.0,964.0,1096.0,51.0,81250.0,1263,36105951900
36,105,952000,1,Block Group 1; Census Tract 9520; Sullivan County; New York,67,287,354,60,0,0,0,0,7,0,287,354,61,115,37,52,22,67,1997,2000,-666666666,732.0,901.0,951.0,24.9,70978.0,634,36105952000
36,105,952000,2,Block Group 2; Census Tract 9520; Sullivan County; New York,0,346,346,0,0,0,0,0,0,0,346,346,166,43,73,18,46,0,1992,1992,-666666666,,,,,120278.0,909,36105952000
36,105,952000,3,Block Group 3; Census Tract 9520; Sullivan County; New York,42,208,250,42,0,0,0,0,0,0,208,250,103,30,35,40,0,42,1990,1997,-666666666,,,,,63016.0,460,36105952000
36,105,952100,1,Block Group 1; Census Tract 9521; Sullivan County; New York,62,348,410,19,0,0,0,7,36,13,348,410,52,82,93,47,61,62,2004,2007,2015,713.0,1291.0,1395.0,28.7,85455.0,950,36105952100
36,105,952100,2,Block Group 2; Census Tract 9521; Sullivan County; New York,152,436,588,33,0,0,0,0,119,6,436,588,81,28,110,173,38,152,2010,2012,2015,642.0,920.0,2166.0,26.8,73750.0,1364,36105952100
36,105,952200,1,Block Group 1; Census Tract 9522; Sullivan County; New York,72,316,388,9,9,4,0,8,42,8,316,388,76,95,81,51,5,72,1999,2002,2015,665.0,695.0,933.0,23.0,56574.0,801,36105952200
36,105,952200,2,Block Group 2; Census Tract 9522; Sullivan County; New York,58,205,263,4,0,4,0,3,47,0,205,263,37,42,59,53,14,58,2004,2008,2014,730.0,775.0,1025.0,32.8,66964.0,540,36105952200
36,105,952300,1,Block Group 1; Census Tract 9523; Sullivan County; New York,61,312,373,21,10,0,0,6,24,20,312,373,60,60,74,65,33,61,2005,2008,2018,573.0,597.0,,19.3,62083.0,834,36105952300
36,105,952300,2,Block Group 2; Census Tract 9523; Sullivan County; New York,41,285,326,21,0,0,0,7,13,0,285,326,29,49,75,107,25,41,2009,2010,2018,491.0,792.0,1573.0,19.0,48125.0,626,36105952300
36,105,952400,1,Block Group 1; Census Tract 9524; Sullivan County; New York,78,557,635,16,9,20,0,0,33,6,557,635,113,57,248,100,33,78,2004,2005,2015,638.0,819.0,990.0,22.5,56027.0,1212,36105952400
36,105,952400,2,Block Group 2; Census Tract 9524; Sullivan County; New York,44,465,509,3,0,8,0,0,33,21,465,509,52,51,147,83,111,44,2009,2010,2013,875.0,1150.0,2042.0,30.0,73542.0,982,36105952400
36,105,952500,1,Block Group 1; Census Tract 9525; Sullivan County; New York,18,209,227,0,0,0,0,18,0,0,209,227,39,29,53,45,43,18,2007,2006,-666666666,,,,,85568.0,559,36105952500
36,105,952500,2,Block Group 2; Census Tract 9525; Sullivan County; New York,7,178,185,0,0,0,0,0,7,0,178,185,7,69,21,81,0,7,2006,2008,-666666666,,,,,101420.0,470,36105952500
36,105,952500,3,Block Group 3; Census Tract 9525; Sullivan County; New York,26,324,350,16,0,0,0,10,0,0,324,350,28,41,130,61,64,26,2007,2008,-666666666,794.0,840.0,887.0,,110833.0,1054,36105952500
36,111,950100,1,Block Group 1; Census Tract 9501; Ulster County; New York,93,425,518,0,0,0,0,16,77,26,425,518,56,94,157,92,0,93,2004,2006,2013,763.0,792.0,1008.0,22.2,64154.0,1353,36111950100
36,111,950100,2,Block Group 2; Census Tract 9501; Ulster County; New York,10,325,335,0,0,0,0,0,10,0,325,335,48,126,88,19,44,10,1999,1999,-666666666,,,,,61509.0,863,36111950100
36,111,950100,3,Block Group 3; Census Tract 9501; Ulster County; New York,68,428,496,68,0,0,0,0,0,0,428,496,48,98,220,57,5,68,2003,2005,-666666666,,,,,71599.0,1134,36111950100
36,111,950100,4,Block Group 4; Census Tract 9501; Ulster County; New York,0,301,301,0,0,0,0,0,0,0,301,301,64,102,51,84,0,0,1998,1998,-666666666,,,,,90259.0,675,36111950100
36,111,950100,5,Block Group 5; Census Tract 9501; Ulster County; New York,12,235,247,0,0,0,0,0,12,0,235,247,89,56,38,21,31,12,1995,1996,-666666666,,,,,77125.0,484,36111950100
36,111,950200,1,Block Group 1; Census Tract 9502; Ulster County; New York,453,226,679,103,0,32,58,127,133,29,226,679,11,32,99,9,46,453,2007,2009,2011,603.0,695.0,1098.0,28.9,55455.0,1575,36111950200
36,111,950200,2,Block Group 2; Census Tract 9502; Ulster County; New York,289,411,700,22,16,0,39,27,185,0,411,700,144,51,156,49,11,289,2001,2006,2013,665.0,845.0,1199.0,38.0,45690.0,1404,36111950200
36,111,950200,3,Block Group 3; Census Tract 9502; Ulster County; New York,300,153,453,30,0,0,13,57,200,0,153,453,29,39,16,27,42,300,2005,2013,2013,919.0,1078.0,1191.0,35.3,67817.0,913,36111950200
36,111,950300,1,Block Group 1; Census Tract 9503; Ulster County; New York,486,350,836,232,42,27,27,30,128,0,350,836,84,60,172,14,20,486,2002,2011,2018,1086.0,1545.0,1845.0,49.0,49881.0,2074,36111950300
36,111,950300,2,Block Group 2; Census Tract 9503; Ulster County; New York,38,406,444,9,0,0,0,0,29,14,406,444,156,39,59,22,116,38,2001,2005,2015,857.0,1028.0,1139.0,14.6,85278.0,984,36111950300
36,111,950300,3,Block Group 3; Census Tract 9503; Ulster County; New York,318,369,687,78,0,0,0,96,144,10,369,687,74,49,129,51,56,318,2005,2010,2014,813.0,1034.0,1155.0,51.0,64205.0,1411,36111950300
36,111,950400,1,Block Group 1; Census Tract 9504; Ulster County; New York,27,208,235,0,0,0,0,0,27,0,208,235,3,41,47,66,51,27,2012,2012,-666666666,,,,,105625.0,602,36111950400
36,111,950400,2,Block Group 2; Census Tract 9504; Ulster County; New York,30,247,277,0,0,0,0,15,15,0,247,277,53,30,105,59,0,30,2004,2005,-666666666,,,,,89799.0,778,36111950400
36,111,950400,3,Block Group 3; Census Tract 9504; Ulster County; New York,79,335,414,0,0,0,0,60,19,0,335,414,148,14,128,45,0,79,2000,2002,2007,1102.0,1140.0,2675.0,51.0,91641.0,958,36111950400
36,111,950400,4,Block Group 4; Census Tract 9504; Ulster County; New York,96,121,217,73,0,0,0,9,14,0,121,217,61,12,32,16,0,96,1989,2009,2019,1033.0,2010.0,2255.0,27.8,113068.0,535,36111950400
36,111,950400,5,Block Group 5; Census Tract 9504; Ulster County; New York,89,338,427,0,0,0,0,39,50,27,338,427,75,37,72,79,48,89,2008,2009,2011,1053.0,1149.0,1245.0,50.0,83487.0,954,36111950400
36,111,950400,6,Block Group 6; Census Tract 9504; Ulster County; New York,100,195,295,55,20,0,0,0,25,0,195,295,38,16,50,91,0,100,2009,2013,2019,1110.0,1403.0,1709.0,37.5,105117.0,572,36111950400
36,111,950500,1,Block Group 1; Census Tract 9505; Ulster County; New York,53,452,505,6,13,0,8,0,26,44,452,505,89,179,58,37,45,53,1998,1999,2016,2250.0,2615.0,2808.0,42.3,87740.0,1020,36111950500
36,111,950500,2,Block Group 2; Census Tract 9505; Ulster County; New York,254,184,438,101,30,0,0,0,123,7,184,438,38,22,61,44,12,254,2005,2015,2018,944.0,1532.0,1853.0,51.0,43571.0,851,36111950500
36,111,950500,3,Block Group 3; Census Tract 9505; Ulster County; New York,297,405,702,57,11,9,16,26,178,0,405,702,169,40,99,79,18,297,1998,2009,2014,772.0,1262.0,1466.0,51.0,63036.0,1370,36111950500
36,111,950600,1,Block Group 1; Census Tract 9506; Ulster County; New York,56,434,490,0,0,8,26,22,0,0,434,490,73,125,82,146,8,56,2002,2001,1998,,,,,105750.0,1047,36111950600
36,111,950600,2,Block Group 2; Census Tract 9506; Ulster County; New York,78,474,552,18,0,0,8,10,42,0,474,552,185,19,103,106,61,78,2003,2006,2014,897.0,1200.0,1399.0,37.5,110417.0,1023,36111950600
36,111,950600,3,Block Group 3; Census Tract 9506; Ulster County; New York,213,364,577,0,45,0,14,92,62,0,364,577,127,35,108,94,0,213,2002,2006,2010,933.0,1113.0,1295.0,24.9,68839.0,954,36111950600
36,111,950900,1,Block Group 1; Census Tract 9509; Ulster County; New York,46,174,220,28,7,0,0,4,7,6,174,220,37,34,34,40,23,46,2005,2010,2019,688.0,950.0,964.0,42.9,80625.0,615,36111950900
36,111,950900,2,Block Group 2; Census Tract 9509; Ulster County; New York,71,287,358,0,0,6,0,33,32,0,287,358,82,80,29,71,25,71,1998,2002,2009,538.0,741.0,1111.0,32.1,65833.0,702,36111950900
36,111,951000,1,Block Group 1; Census Tract 9510; Ulster County; New York,29,206,235,0,0,0,0,0,29,0,206,235,85,55,33,33,0,29,1993,1996,-666666666,,,,,76820.0,485,36111951000
36,111,951000,2,Block Group 2; Census Tract 9510; Ulster County; New York,104,523,627,32,0,0,0,0,72,19,523,627,230,97,115,53,9,104,1993,1999,2016,836.0,2292.0,2094.0,31.4,68958.0,1644,36111951000
36,111,951000,3,Block Group 3; Census Tract 9510; Ulster County; New York,52,558,610,0,0,0,14,24,14,0,558,610,112,187,145,88,26,52,1999,2000,2005,,,,,120278.0,1232,36111951000
36,111,951000,4,Block Group 4; Census Tract 9510; Ulster County; New York,59,298,357,28,0,0,0,0,31,0,298,357,48,47,69,117,17,59,2008,2011,2018,1192.0,2077.0,2289.0,51.0,94738.0,889,36111951000
36,111,951100,1,Block Group 1; Census Tract 9511; Ulster County; New York,28,224,252,0,0,0,0,0,28,0,224,252,38,106,6,58,16,28,1997,1998,-666666666,1313.0,1458.0,1708.0,20.8,85833.0,565,36111951100
36,111,951100,2,Block Group 2; Census Tract 9511; Ulster County; New York,24,386,410,0,0,0,0,0,24,84,386,410,86,47,53,91,25,24,2011,2011,-666666666,,,,,69419.0,760,36111951100
36,111,951100,3,Block Group 3; Census Tract 9511; Ulster County; New York,21,333,354,10,0,0,0,11,0,0,333,354,76,24,38,165,30,21,2011,2011,-666666666,,,,,60217.0,805,36111951100
36,111,951200,1,Block Group 1; Census Tract 9512; Ulster County; New York,19,331,350,0,0,0,0,0,19,0,331,350,37,67,55,145,27,19,2010,2011,-666666666,,1304.0,1402.0,51.0,94000.0,1026,36111951200
36,111,951200,2,Block Group 2; Census Tract 9512; Ulster County; New York,53,315,368,7,0,0,12,0,34,0,315,368,57,57,70,131,0,53,2006,2008,2013,946.0,1085.0,1203.0,51.0,136500.0,935,36111951200
36,111,951200,3,Block Group 3; Census Tract 9512; Ulster County; New York,16,430,446,0,0,9,0,0,7,51,430,446,164,31,23,132,29,16,2009,2008,-666666666,,,,,104265.0,898,36111951200
36,111,951200,4,Block Group 4; Census Tract 9512; Ulster County; New York,38,470,508,0,0,0,0,12,26,0,470,508,77,67,180,126,20,38,2005,2006,-666666666,1082.0,1163.0,,27.2,108333.0,1187,36111951200
36,111,951300,1,Block Group 1; Census Tract 9513; Ulster County; New York,233,535,768,64,0,0,0,64,105,0,535,768,273,56,71,103,32,233,1989,2004,2014,755.0,800.0,1293.0,27.3,74662.0,1684,36111951300
36,111,951300,2,Block Group 2; Census Tract 9513; Ulster County; New York,297,303,600,89,82,43,0,10,73,0,303,600,57,76,49,80,41,297,2004,2013,2019,1341.0,1537.0,1769.0,20.5,85347.0,1720,36111951300
36,111,951300,3,Block Group 3; Census Tract 9513; Ulster County; New York,90,248,338,40,0,8,0,0,42,9,248,338,44,67,61,33,34,90,2002,2008,2017,885.0,1036.0,1143.0,33.1,60833.0,764,36111951300
36,111,951400,1,Block Group 1; Census Tract 9514; Ulster County; New York,242,340,582,86,0,0,0,0,156,0,340,582,48,47,82,127,36,242,2009,2013,2016,494.0,646.0,933.0,42.6,45208.0,1316,36111951400
36,111,951400,2,Block Group 2; Census Tract 9514; Ulster County; New York,521,184,705,132,0,0,16,52,321,0,184,705,53,26,29,61,15,521,2004,2014,2015,436.0,965.0,1456.0,30.7,41490.0,1424,36111951400
36,111,951400,3,Block Group 3; Census Tract 9514; Ulster County; New York,61,281,342,0,0,4,18,30,9,14,281,342,69,24,99,69,6,61,2005,2004,2003,825.0,961.0,1245.0,15.8,119868.0,1016,36111951400
36,111,951500,1,Block Group 1; Census Tract 9515; Ulster County; New York,16,107,123,7,0,0,0,9,0,0,107,123,5,26,17,49,10,16,2011,2011,-666666666,,,,,104821.0,351,36111951500
36,111,951500,2,Block Group 2; Census Tract 9515; Ulster County; New York,42,252,294,0,0,19,0,10,13,0,252,294,53,34,50,90,25,42,2008,2007,2002,1100.0,1200.0,1333.0,24.4,125000.0,893,36111951500
36,111,951500,3,Block Group 3; Census Tract 9515; Ulster County; New York,72,327,399,13,0,3,5,23,28,13,327,399,82,29,58,136,9,72,2009,2010,2011,1080.0,1223.0,1636.0,36.3,57917.0,952,36111951500
36,111,951500,4,Block Group 4; Census Tract 9515; Ulster County; New York,202,456,658,61,0,0,0,30,111,6,456,658,78,34,112,119,107,202,2010,2013,2015,1258.0,1524.0,1762.0,23.9,99211.0,1364,36111951500
36,111,951600,1,Block Group 1; Census Tract 9516; Ulster County; New York,14,274,288,0,0,7,0,0,7,8,274,288,76,28,10,138,14,14,2011,2011,-666666666,,,,,64764.0,757,36111951600
36,111,951600,2,Block Group 2; Census Tract 9516; Ulster County; New York,85,512,597,0,8,15,21,0,41,0,512,597,136,91,162,82,41,85,2002,2002,2011,1086.0,1531.0,1849.0,25.7,75568.0,1330,36111951600
36,111,951700,1,Block Group 1; Census Tract 9517; Ulster County; New York,109,223,332,19,0,0,70,20,0,16,223,332,34,0,45,112,16,109,2012,2010,1998,938.0,976.0,1069.0,23.0,87813.0,838,36111951700
36,111,951700,2,Block Group 2; Census Tract 9517; Ulster County; New York,372,279,651,177,0,0,0,81,114,22,279,651,134,78,11,17,17,372,1991,2011,2017,991.0,1148.0,1642.0,29.4,54688.0,1927,36111951700
36,111,951700,3,Block Group 3; Census Tract 9517; Ulster County; New York,264,0,264,96,0,0,0,0,168,0,0,264,0,0,0,0,0,264,-666666666,2016,2016,,1021.0,1148.0,39.1,,352,36111951700
36,111,951700,4,Block Group 4; Census Tract 9517; Ulster County; New York,101,110,211,36,13,0,18,0,34,0,110,211,20,27,15,48,0,101,2005,2012,2018,1040.0,1353.0,1593.0,30.2,123563.0,450,36111951700
36,111,951700,5,Block Group 5; Census Tract 9517; Ulster County; New York,201,323,524,76,13,0,0,19,93,16,323,524,70,0,35,202,0,201,2012,2014,2017,852.0,1027.0,1347.0,24.7,58667.0,949,36111951700
36,111,951800,1,Block Group 1; Census Tract 9518; Ulster County; New York,429,263,692,102,0,12,11,76,228,6,263,692,52,62,42,76,25,429,2004,2012,2014,438.0,668.0,1272.0,34.5,33712.0,1656,36111951800
36,111,951900,1,Block Group 1; Census Tract 9519; Ulster County; New York,125,202,327,39,0,0,0,0,86,0,202,327,47,26,45,76,8,125,2006,2012,2016,1074.0,1591.0,1917.0,33.3,130809.0,1242,36111951900
36,111,951900,2,Block Group 2; Census Tract 9519; Ulster County; New York,30,281,311,30,0,0,0,0,0,0,281,311,97,48,94,30,12,30,1999,2001,-666666666,,,,,95938.0,852,36111951900
36,111,951900,3,Block Group 3; Census Tract 9519; Ulster County; New York,80,134,214,0,0,11,0,7,62,0,134,214,84,0,0,37,13,80,1989,2010,2013,770.0,1000.0,1125.0,41.3,46184.0,583,36111951900
36,111,951900,4,Block Group 4; Census Tract 9519; Ulster County; New York,66,159,225,17,0,4,0,0,45,0,159,225,46,17,18,69,9,66,2009,2012,2015,974.0,1554.0,1777.0,23.9,101146.0,618,36111951900
36,111,952000,1,Block Group 1; Census Tract 9520; Ulster County; New York,210,288,498,57,0,0,0,9,144,0,288,498,76,5,62,94,51,210,2010,2013,2015,746.0,978.0,1120.0,24.5,65682.0,1234,36111952000
36,111,952000,2,Block Group 2; Census Tract 9520; Ulster County; New York,308,250,558,41,25,0,0,14,228,0,250,558,0,109,42,42,57,308,2004,2013,2015,935.0,1108.0,1369.0,42.9,49091.0,1507,36111952000
36,111,952100,1,Block Group 1; Census Tract 9521; Ulster County; New York,361,109,470,231,12,0,8,0,110,0,109,470,46,6,23,23,11,361,2001,2018,2019,918.0,1380.0,1630.0,37.2,55313.0,976,36111952100
36,111,952100,2,Block Group 2; Census Tract 9521; Ulster County; New York,130,50,180,33,31,0,0,0,66,0,50,180,24,0,1,7,18,130,2010,2017,2018,1340.0,1596.0,1798.0,29.3,78125.0,619,36111952100
36,111,952100,3,Block Group 3; Census Tract 9521; Ulster County; New York,239,85,324,103,23,0,9,0,104,0,85,324,6,10,21,29,19,239,2012,2017,2018,1010.0,1162.0,1371.0,20.1,88571.0,1024,36111952100
36,111,952100,4,Block Group 4; Census Tract 9521; Ulster County; New York,304,142,446,50,33,0,0,108,113,0,142,446,5,3,48,86,0,304,2011,2012,2013,990.0,1107.0,1215.0,29.1,65068.0,1139,36111952100
36,111,952200,1,Block Group 1; Census Tract 9522; Ulster County; New York,119,269,388,37,0,0,0,17,65,0,269,388,83,21,50,60,55,119,2006,2011,2015,945.0,1030.0,1193.0,26.1,115357.0,659,36111952200
36,111,952200,2,Block Group 2; Census Tract 9522; Ulster County; New York,95,175,270,37,0,0,0,10,48,0,175,270,38,9,12,116,0,95,2012,2013,2016,1102.0,1205.0,1340.0,24.6,113088.0,543,36111952200
36,111,952200,3,Block Group 3; Census Tract 9522; Ulster County; New York,177,230,407,78,0,0,0,9,90,0,230,407,48,10,81,73,18,177,2007,2013,2017,915.0,998.0,1498.0,31.8,80375.0,1135,36111952200
36,111,952200,4,Block Group 4; Census Tract 9522; Ulster County; New York,146,357,503,77,37,0,0,6,26,0,357,503,67,54,102,102,32,146,2006,2011,2020,1288.0,1414.0,1619.0,27.7,76325.0,1627,36111952200
36,111,952300,1,Block Group 1; Census Tract 9523; Ulster County; New York,218,53,271,11,7,0,20,79,101,0,53,271,7,14,32,0,0,218,2002,2009,2011,1070.0,1220.0,1486.0,22.3,84830.0,643,36111952300
36,111,952300,2,Block Group 2; Census Tract 9523; Ulster County; New York,262,214,476,91,25,0,7,25,114,0,214,476,83,43,54,34,0,262,1996,2011,2017,937.0,1005.0,1165.0,26.1,59878.0,867,36111952300
36,111,952400,1,Block Group 1; Census Tract 9524; Ulster County; New York,590,76,666,197,35,22,0,59,277,0,76,666,10,6,9,51,0,590,2012,2016,2016,915.0,1111.0,1509.0,39.6,36585.0,1349,36111952400
36,111,952400,2,Block Group 2; Census Tract 9524; Ulster County; New York,199,414,613,29,65,25,0,12,68,80,414,613,39,69,61,138,27,199,2012,2014,2017,386.0,1006.0,1128.0,51.0,60508.0,1229,36111952400
36,111,952500,1,Block Group 1; Census Tract 9525; Ulster County; New York,100,232,332,10,0,0,16,28,46,0,232,332,49,74,71,34,4,100,1999,2003,2011,858.0,1275.0,1695.0,51.0,81806.0,777,36111952500
36,111,952500,2,Block Group 2; Census Tract 9525; Ulster County; New York,48,551,599,6,27,4,11,0,0,13,551,599,75,136,122,156,49,48,2005,2006,2022,,1068.0,1159.0,22.4,95096.0,1355,36111952500
36,111,952500,3,Block Group 3; Census Tract 9525; Ulster County; New York,96,358,454,43,0,0,0,0,53,0,358,454,84,83,96,37,58,96,2001,2006,2017,1146.0,1282.0,1391.0,34.4,61176.0,1243,36111952500
36,111,952600,1,Block Group 1; Census Tract 9526; Ulster County; New York,159,261,420,0,0,0,0,16,143,0,261,420,121,13,48,36,43,159,1997,2011,2014,930.0,1558.0,1779.0,35.1,54879.0,1342,36111952600
36,111,952600,2,Block Group 2; Census Tract 9526; Ulster County; New York,100,257,357,61,0,0,11,17,11,0,257,357,41,37,121,46,12,100,2004,2006,2019,710.0,1323.0,1412.0,19.2,95481.0,1633,36111952600
36,111,952600,3,Block Group 3; Census Tract 9526; Ulster County; New York,46,609,655,0,0,0,0,0,46,9,609,655,139,14,375,72,0,46,2004,2005,-666666666,,,,,147404.0,1381,36111952600
36,111,952600,4,Block Group 4; Census Tract 9526; Ulster County; New York,47,476,523,0,0,0,0,0,47,0,476,523,78,15,153,230,0,47,2009,2010,-666666666,,,,,,637,36111952600
36,111,952600,5,Block Group 5; Census Tract 9526; Ulster County; New York,105,322,427,0,0,0,0,0,105,0,322,427,73,55,83,87,24,105,2004,2010,-666666666,854.0,,1663.0,26.0,115139.0,1156,36111952600
36,111,952700,1,Block Group 1; Census Tract 9527; Ulster County; New York,77,269,346,50,0,0,7,0,20,0,269,346,74,47,27,62,59,77,2005,2012,2019,923.0,980.0,1099.0,25.8,64605.0,837,36111952700
36,111,952700,2,Block Group 2; Census Tract 9527; Ulster County; New York,159,224,383,90,7,0,0,21,41,7,224,383,41,45,63,60,8,159,2004,2012,2019,893.0,1219.0,2548.0,51.0,49097.0,861,36111952700
36,111,952700,3,Block Group 3; Census Tract 9527; Ulster County; New York,182,382,564,45,0,0,0,59,78,38,382,564,38,45,46,30,185,182,2019,2017,2013,851.0,932.0,989.0,23.8,65167.0,1181,36111952700
36,111,952800,1,Block Group 1; Census Tract 9528; Ulster County; New York,67,331,398,21,11,0,9,3,23,10,331,398,116,44,47,107,7,67,2001,2006,2017,476.0,753.0,975.0,28.2,91176.0,776,36111952800
36,111,952800,2,Block Group 2; Census Tract 9528; Ulster County; New York,202,354,556,150,0,0,0,12,40,0,354,556,65,43,90,125,31,202,2008,2013,-666666666,1166.0,1352.0,1490.0,46.3,55100.0,1500,36111952800
36,111,952800,3,Block Group 3; Census Tract 9528; Ulster County; New York,22,228,250,12,0,0,0,0,10,0,228,250,74,71,37,46,0,22,1996,1997,2018,898.0,2125.0,2313.0,51.0,72000.0,644,36111952800
36,111,952901,1,Block Group 1; Census Tract 9529.01; Ulster County; New York,88,225,313,18,9,0,10,0,51,8,225,313,75,33,79,30,0,88,2001,2005,2015,993.0,1236.0,1743.0,40.3,58125.0,719,36111952901
36,111,952901,2,Block Group 2; Census Tract 9529.01; Ulster County; New York,20,314,334,12,0,0,0,0,8,5,314,334,158,27,95,19,10,20,1989,1993,-666666666,,,,,148077.0,765,36111952901
36,111,952901,3,Block Group 3; Census Tract 9529.01; Ulster County; New York,77,374,451,25,0,0,0,0,52,0,374,451,71,37,93,103,70,77,2008,2011,2016,526.0,754.0,1027.0,32.7,102537.0,1336,36111952901
36,111,952902,1,Block Group 1; Census Tract 9529.02; Ulster County; New York,16,703,719,0,0,0,0,0,16,0,703,719,118,130,277,133,45,16,2004,2004,-666666666,,1255.0,1378.0,40.2,92821.0,1624,36111952902
36,111,952902,2,Block Group 2; Census Tract 9529.02; Ulster County; New York,14,513,527,14,0,0,0,0,0,12,513,527,217,37,122,79,46,14,2000,2001,-666666666,,,,,,1230,36111952902
36,111,953000,1,Block Group 1; Census Tract 9530; Ulster County; New York,82,599,681,15,0,0,14,7,46,59,599,681,66,34,236,183,21,82,2008,2009,2013,730.0,747.0,1840.0,51.0,103750.0,1526,36111953000
36,111,953000,2,Block Group 2; Census Tract 9530; Ulster County; New York,80,202,282,17,0,8,30,0,25,0,202,282,53,25,99,4,21,80,2002,2003,2011,539.0,670.0,986.0,51.0,77188.0,619,36111953000
36,111,953300,1,Block Group 1; Census Tract 9533; Ulster County; New York,105,356,461,26,13,9,0,22,35,0,356,461,76,41,115,54,70,105,2005,2008,2015,796.0,2098.0,2755.0,24.1,131750.0,1587,36111953300
36,111,953300,2,Block Group 2; Census Tract 9533; Ulster County; New York,50,428,478,41,0,0,0,0,9,9,428,478,52,98,42,183,44,50,2011,2012,2019,1007.0,1191.0,1429.0,31.7,150294.0,1032,36111953300
36,111,953300,3,Block Group 3; Census Tract 9533; Ulster County; New York,184,577,761,51,0,0,9,97,27,8,577,761,60,161,116,187,45,184,2006,2007,2009,706.0,741.0,1743.0,36.7,127872.0,2060,36111953300
36,111,953400,1,Block Group 1; Census Tract 9534; Ulster County; New York,85,375,460,0,0,0,0,0,85,50,375,460,152,72,26,51,24,85,1995,2002,-666666666,,,,,112946.0,1035,36111953400
36,111,953400,2,Block Group 2; Census Tract 9534; Ulster County; New York,404,71,475,57,59,0,34,12,242,0,71,475,30,14,27,0,0,404,1994,2014,2015,932.0,1116.0,1606.0,46.4,24712.0,870,36111953400
36,111,953400,3,Block Group 3; Census Tract 9534; Ulster County; New York,366,371,737,122,15,0,0,16,213,15,371,737,142,32,79,103,0,366,2001,2013,2016,1644.0,1820.0,1996.0,28.7,96076.0,1286,36111953400
36,111,953400,4,Block Group 4; Census Tract 9534; Ulster County; New York,439,127,566,172,85,0,35,28,119,10,127,566,16,13,45,43,0,439,2008,2017,2019,822.0,1157.0,1678.0,51.0,43654.0,1864,36111953400
36,111,953500,1,Block Group 1; Census Tract 9535; Ulster County; New York,250,146,396,51,47,0,0,0,152,29,146,396,18,15,45,39,0,250,2009,2015,2017,1076.0,1213.0,1473.0,48.0,54375.0,730,36111953500
36,111,953500,2,Block Group 2; Census Tract 9535; Ulster County; New York,345,81,426,199,10,10,0,12,114,0,81,426,12,30,25,14,0,345,2000,2018,2019,858.0,1502.0,1880.0,37.1,,3730,36111953500
36,111,953500,3,Block Group 3; Census Tract 9535; Ulster County; New York,61,150,211,43,0,0,0,0,18,0,150,211,74,25,7,20,24,61,1990,2009,2019,1281.0,1493.0,1746.0,31.4,132596.0,593,36111953500
36,111,953600,1,Block Group 1; Census Tract 9536; Ulster County; New York,130,426,556,17,1,0,20,49,43,0,426,556,35,45,223,76,47,130,2006,2007,2009,914.0,949.0,984.0,24.7,95714.0,1346,36111953600
36,111,953600,2,Block Group 2; Census Tract 9536; Ulster County; New York,383,391,774,47,0,0,0,101,235,32,391,774,73,34,128,111,13,383,2007,2011,2013,1123.0,1515.0,1914.0,27.9,76221.0,1917,36111953600
36,111,953600,3,Block Group 3; Census Tract 9536; Ulster County; New York,170,411,581,110,0,0,0,50,10,0,411,581,25,0,87,144,155,170,2015,2017,2019,1665.0,1829.0,1994.0,51.0,158561.0,1926,36111953600
36,111,953600,4,Block Group 4; Census Tract 9536; Ulster County; New York,312,116,428,119,14,0,0,36,143,0,116,428,19,5,13,79,0,312,2012,2015,2017,929.0,1011.0,1228.0,23.9,71207.0,773,36111953600
36,111,953700,1,Block Group 1; Census Tract 9537; Ulster County; New York,148,697,845,59,15,0,0,0,74,0,697,845,140,147,201,196,13,148,2003,2007,2018,1557.0,2250.0,2696.0,26.8,99018.0,1732,36111953700
36,111,953700,2,Block Group 2; Census Tract 9537; Ulster County; New York,241,345,586,62,0,0,19,14,146,0,345,586,6,187,12,115,25,241,1999,2012,2015,1018.0,1224.0,2217.0,41.0,71774.0,1402,36111953700
36,111,953700,3,Block Group 3; Census Tract 9537; Ulster County; New York,24,181,205,0,0,0,0,0,24,0,181,205,85,31,28,37,0,24,1992,1996,-666666666,,,,,78550.0,468,36111953700
36,111,953700,4,Block Group 4; Census Tract 9537; Ulster County; New York,35,489,524,0,0,0,0,0,35,0,489,524,50,123,84,147,85,35,2009,2010,-666666666,818.0,,2059.0,37.1,78854.0,1577,36111953700
36,111,953800,1,Block Group 1; Census Tract 9538; Ulster County; New York,316,474,790,24,0,0,42,121,129,12,474,790,97,60,178,102,25,316,2004,2007,2010,,1174.0,2060.0,19.2,83125.0,1801,36111953800
36,111,953800,2,Block Group 2; Census Tract 9538; Ulster County; New York,208,220,428,22,14,0,0,42,130,0,220,428,68,20,22,103,7,208,2010,2012,2014,693.0,839.0,1095.0,34.3,57260.0,953,36111953800
36,111,953800,3,Block Group 3; Census Tract 9538; Ulster County; New York,137,367,504,37,18,20,0,0,62,0,367,504,57,105,125,62,18,137,2002,2006,2016,993.0,1239.0,1869.0,26.5,101429.0,1297,36111953800
36,111,953900,1,Block Group 1; Census Tract 9539; Ulster County; New York,96,624,720,13,0,0,0,21,62,23,624,720,126,185,95,110,85,96,2000,2004,2013,1308.0,1613.0,1806.0,36.2,111475.0,1796,36111953900
36,111,953900,2,Block Group 2; Census Tract 9539; Ulster County; New York,154,629,783,34,15,0,0,12,93,0,629,783,124,222,142,124,17,154,1999,2003,2016,971.0,1173.0,1712.0,29.2,88375.0,1935,36111953900
36,111,953900,3,Block Group 3; Census Tract 9539; Ulster County; New York,51,335,386,0,0,0,0,0,51,0,335,386,29,69,93,34,110,51,2007,2010,-666666666,1086.0,1172.0,1545.0,39.1,211250.0,966,36111953900
36,111,954000,1,Block Group 1; Census Tract 9540; Ulster County; New York,260,438,698,89,49,0,19,0,103,0,438,698,87,99,56,169,27,260,2006,2013,2018,747.0,903.0,992.0,48.5,47014.0,1415,36111954000
36,111,954000,2,Block Group 2; Census Tract 9540; Ulster County; New York,93,617,710,17,0,0,0,22,54,0,617,710,107,70,215,146,79,93,2006,2008,2014,1268.0,1569.0,1785.0,14.3,65278.0,1401,36111954000
36,111,954000,3,Block Group 3; Census Tract 9540; Ulster County; New York,147,502,649,132,0,15,0,0,0,0,502,649,123,133,157,58,31,147,2000,2003,-666666666,664.0,678.0,737.0,9.0,113724.0,2089,36111954000
36,111,954100,1,Block Group 1; Census Tract 9541; Ulster County; New York,129,300,429,44,0,0,45,11,29,0,300,429,86,10,75,86,43,129,2007,2009,2012,1003.0,1342.0,2039.0,25.6,112721.0,1478,36111954100
36,111,954100,2,Block Group 2; Census Tract 9541; Ulster County; New York,369,413,782,35,0,23,10,0,301,0,413,782,56,61,153,68,75,369,2006,2012,2014,758.0,835.0,881.0,14.7,115625.0,1724,36111954100
36,111,954100,3,Block Group 3; Census Tract 9541; Ulster County; New York,158,339,497,26,0,0,0,26,106,0,339,497,40,90,66,51,92,158,2006,2011,2014,1301.0,1431.0,1659.0,36.1,104049.0,1400,36111954100
36,111,954100,4,Block Group 4; Census Tract 9541; Ulster County; New York,96,260,356,17,22,11,0,0,46,0,260,356,59,0,115,13,73,96,2006,2009,2016,1679.0,1750.0,2038.0,33.1,77955.0,925,36111954100
36,111,954200,1,Block Group 1; Census Tract 9542; Ulster County; New York,116,209,325,0,0,0,0,110,6,0,209,325,53,62,17,67,10,116,1998,2004,2005,,,980.0,20.0,94539.0,932,36111954200
36,111,954200,2,Block Group 2; Census Tract 9542; Ulster County; New York,82,272,354,20,8,0,0,33,21,37,272,354,76,27,31,71,30,82,2010,2011,2013,1063.0,1500.0,1811.0,33.8,86600.0,795,36111954200
36,111,954200,3,Block Group 3; Census Tract 9542; Ulster County; New York,5,187,192,5,0,0,0,0,0,0,187,192,15,80,52,29,11,5,2000,2000,-666666666,922.0,1022.0,1136.0,24.2,180431.0,3350,36111954200
36,111,954200,4,Block Group 4; Census Tract 9542; Ulster County; New York,119,149,268,38,12,0,13,14,42,0,149,268,9,52,19,21,48,119,2007,2013,2016,978.0,1234.0,1723.0,26.1,90547.0,552,36111954200
36,111,954401,1,Block Group 1; Census Tract 9544.01; Ulster County; New York,52,393,445,0,14,0,0,5,33,0,393,445,47,48,219,50,29,52,2005,2006,2015,1232.0,1341.0,1439.0,36.1,162652.0,2067,36111954401
36,111,954401,2,Block Group 2; Census Tract 9544.01; Ulster County; New York,79,445,524,28,24,0,0,0,27,0,445,524,40,66,158,144,37,79,2007,2010,2019,1060.0,1273.0,2105.0,23.0,195333.0,1640,36111954401
36,111,954402,1,Block Group 1; Census Tract 9544.02; Ulster County; New York,57,600,657,31,0,10,0,0,16,0,600,657,83,37,105,199,176,57,2013,2013,2018,853.0,911.0,997.0,36.5,72452.0,1872,36111954402
36,111,954402,2,Block Group 2; Census Tract 9544.02; Ulster County; New York,163,530,693,0,108,11,0,0,44,0,530,693,90,124,157,69,90,163,2003,2008,2022,1216.0,1932.0,2232.0,37.7,87625.0,2264,36111954402
36,111,954402,3,Block Group 3; Census Tract 9544.02; Ulster County; New York,53,432,485,0,0,0,0,0,53,17,432,485,129,95,81,83,27,53,1999,2002,-666666666,821.0,858.0,,22.9,96875.0,1105,36111954402
36,111,954500,1,Block Group 1; Census Tract 9545; Ulster County; New York,243,161,404,15,0,0,0,14,214,0,161,404,82,37,10,32,0,243,1989,2012,2014,730.0,822.0,887.0,31.9,54278.0,986,36111954500
36,111,954500,2,Block Group 2; Census Tract 9545; Ulster County; New York,45,190,235,45,0,0,0,0,0,0,190,235,62,0,30,65,33,45,2010,2013,-666666666,726.0,1007.0,,51.0,33750.0,1695,36111954500
36,111,954500,3,Block Group 3; Census Tract 9545; Ulster County; New York,33,264,297,0,0,11,0,0,22,0,264,297,65,43,61,64,31,33,2004,2005,-666666666,,,,,113051.0,698,36111954500
36,111,954500,4,Block Group 4; Census Tract 9545; Ulster County; New York,0,166,166,0,0,0,0,0,0,0,166,166,37,0,29,100,0,0,2011,2011,-666666666,,,,,113068.0,483,36111954500
36,111,954600,1,Block Group 1; Census Tract 9546; Ulster County; New York,46,286,332,0,6,0,0,0,40,12,286,332,53,55,94,72,0,46,2004,2006,2015,1020.0,993.0,1182.0,40.7,70577.0,933,36111954600
36,111,954600,2,Block Group 2; Census Tract 9546; Ulster County; New York,42,295,337,0,0,20,0,0,22,7,295,337,85,47,77,76,3,42,2002,2002,2010,,,,,46827.0,644,36111954600
36,111,954700,1,Block Group 1; Census Tract 9547; Ulster County; New York,30,280,310,0,0,0,0,0,30,8,280,310,97,7,85,73,10,30,2004,2006,-666666666,629.0,850.0,1105.0,14.2,81875.0,1131,36111954700
36,111,954700,2,Block Group 2; Census Tract 9547; Ulster County; New York,16,237,253,0,0,0,0,16,0,2,237,253,34,58,79,46,18,16,2003,2004,-666666666,1090.0,1180.0,1295.0,32.2,115450.0,671,36111954700
36,111,954800,1,Block Group 1; Census Tract 9548; Ulster County; New York,339,401,740,0,12,0,45,129,153,0,401,740,57,128,157,59,0,339,2001,2005,2010,575.0,915.0,1031.0,51.0,94904.0,2191,36111954800
36,111,954800,2,Block Group 2; Census Tract 9548; Ulster County; New York,428,337,765,54,0,0,87,42,245,0,337,765,55,45,152,41,44,428,2005,2010,2013,706.0,903.0,975.0,41.7,44627.0,1250,36111954800
36,111,954800,3,Block Group 3; Census Tract 9548; Ulster County; New York,375,459,834,71,108,46,0,0,150,21,459,834,190,0,147,52,49,375,2003,2011,2018,632.0,719.0,904.0,51.0,65333.0,2001,36111954800
36,111,954900,1,Block Group 1; Census Tract 9549; Ulster County; New York,215,538,753,91,7,7,0,8,102,0,538,753,125,93,78,139,103,215,2007,2012,2017,880.0,1516.0,1926.0,25.2,95781.0,1818,36111954900
36,111,955001,1,Block Group 1; Census Tract 9550.01; Ulster County; New York,81,345,426,0,0,13,0,23,45,0,345,426,86,53,107,75,24,81,2003,2005,2011,590.0,954.0,1630.0,51.0,58167.0,1017,36111955001
36,111,955001,2,Block Group 2; Census Tract 9550.01; Ulster County; New York,104,457,561,59,0,27,18,0,0,0,457,561,73,103,138,62,81,104,2004,2004,2018,441.0,,932.0,25.3,76094.0,1228,36111955001
36,111,955002,1,Block Group 1; Census Tract 9550.02; Ulster County; New York,96,390,486,17,0,0,0,0,79,0,390,486,55,24,74,113,124,96,2013,2014,2015,835.0,1265.0,1382.0,13.5,74392.0,1327,36111955002
36,111,955002,2,Block Group 2; Census Tract 9550.02; Ulster County; New York,150,514,664,0,0,0,0,92,58,0,514,664,35,95,192,156,36,150,2007,2007,2008,650.0,672.0,737.0,51.0,81591.0,1588,36111955002
36,111,955400,1,Block Group 1; Census Tract 9554; Ulster County; New York,275,423,698,127,42,0,0,0,106,0,423,698,45,109,53,150,66,275,2010,2014,2019,858.0,922.0,1253.0,25.4,71705.0,1672,36111955400
36,111,955400,2,Block Group 2; Census Tract 9554; Ulster County; New York,52,295,347,8,0,4,0,40,0,19,295,347,87,43,75,63,8,52,2002,2003,2006,,,,,123750.0,1885,36111955400
36,111,955400,3,Block Group 3; Census Tract 9554; Ulster County; New York,43,329,372,10,0,0,0,0,33,22,329,372,57,47,25,164,14,43,2012,2012,2015,723.0,1208.0,1332.0,13.7,131750.0,988,36111955400
